情非得已	庾澄庆	海啸
春泥	庾澄庆	哈林天堂
命中注定	庾澄庆	哈世纪Live Show
让我一次爱个够	庾澄庆	想念你精选
热情的沙漠	庾澄庆	哈林夜总会
静静的	庾澄庆	戒不掉
告白气球 (Live)	庾澄庆	梦想的声音第二季 第8期
水手 (改编版)	庾澄庆	极限公益晚会
关不掉的月光	庾澄庆	关不掉的月光
缺口	庾澄庆	等一个人咖啡 电影原声带
我最摇摆	庾澄庆	1987-1999 精选辑
梦醒时分	庾澄庆	哈林夜总会
想念你	庾澄庆	错过的爱
想你，醒在0:03	庾澄庆	只有为你
情非得已 (Live)	庾澄庆	精彩音乐汇
让我一次爱个够 + 征服 + 哭不出来 + 存在 (Live)	庾澄庆|张惠妹|那英	梦响新歌声第二季 第1期
快乐颂	庾澄庆	Harlem No.1 Collection 1987-1998
对你爱不完	庾澄庆	哈林夜总会
新不了情	庾澄庆	哈LLYWOOD
改变所有的错	庾澄庆	想念你精选
牧羊曲	郑绪岚	郑绪岚独唱歌曲选
枉凝眉	郑绪岚	中国歌唱家系列之牧羊曲
太阳岛上	郑绪岚	郑绪岚独唱歌曲选
化蝶	郑绪岚	20世纪中华歌坛名人百集珍藏版
鼓浪岐之波	郑绪岚	中国歌唱家系列之牧羊曲
葬花吟	郑绪岚	情系红楼梦
红楼梦序曲	郑绪岚	空
大海啊故乡	郑绪岚	中国歌唱家系列之牧羊曲
妈妈留给我一首歌	郑绪岚	郑绪岚独唱歌曲选
红豆曲	郑绪岚	情系红楼梦
飞吧鸽子	郑绪岚	中国歌唱家系列之牧羊曲
牧羊曲 (Live)	郑绪岚	王牌对王牌第三季 第4期
沂蒙山小调	郑绪岚	郑绪岚独唱歌曲选
妈妈留给我一首歌	郑绪岚	原唱经典名曲珍藏（10）
紫菱州歌	郑绪岚	情系红楼梦
化蝶	郑绪岚	中国当代名曲2
太阳岛上	郑绪岚	原唱流行经典名曲（3）
让我们荡起双桨 + 我们的田野 + 听妈妈讲那过去的事情	郑绪岚	我们的歌
大海啊，故乡	郑绪岚	中国当代名曲1
听妈妈讲那过去的事情	郑绪岚	献给孩子
海阔天空 (Live)	黄贯中	我是歌手第一季 第1期
我终于失去了你 (Live)	黄贯中	我是歌手第一季 第3期
特别的爱给特别的你 (Live)	黄贯中	我是歌手第一季 第11期
光辉岁月 (Live)	黄贯中	围炉音乐会 第21期
天与地	黄贯中	A小调协奏曲
大地 (Live)	李克勤|黄贯中	你的克勤演奏厅
吻别 (Live)	黄贯中	我是歌手第一季 第2期
灰色轨迹 (Live)	黄贯中	围炉音乐会 第21期
Can't Bring Me Down	黄贯中	A小调协奏曲
再见理想 (Live)	黄贯中	别了家驹十五载 海阔天空音乐会
大地 (Live)	黄贯中	围炉音乐会 第21期
故事	黄贯中	A小调协奏曲
海阔天空 (Live)	黄贯中	别了家驹十五载 海阔天空音乐会
永远的兄弟	黄贯中	永远的兄弟
新秩序	黄贯中	Paul Wong Collection
爱又怎么样	黄贯中	A小调协奏曲
海阔天空 (Live)	黄贯中	围炉音乐会 第21期
无得比	黄贯中	黄贯中
小姐你好嘢 (Album Version)	李克勤|黄贯中	李克勤大乐队
自由人 (独唱版)	黄贯中	黑白
上海滩	叶丽仪	上海滩
我们相见又分手	叶丽仪	你会爱上它 87'春节晚会歌曲精选
铁血丹心 (Live)	叶丽仪	顾嘉辉大师经典演唱会
万水千山纵横 (Live)	叶丽仪	叶丽仪45年香港情演唱会
新上海滩	叶丽仪	新上海滩电视原声带
仙鹤情缘	叶丽仪	仙鹤神针 电影原声带
笑傲江湖	叶丽仪	EMI至爱经典系列
何日君再来	叶丽仪	想念依旧（第2辑）
万般情	叶丽仪	上海滩续集
时间都去哪儿了 (粤语|Live)	叶丽仪	叶丽仪45年香港情演唱会
夜来香 (Live)	叶丽仪	叶丽仪45年香港情演唱会
天涯歌女	叶丽仪	想念依旧（第1辑）
莫问我是谁	叶丽仪	笑迎人生
上海滩龙虎斗	叶丽仪	多一点精选集 (二) : 叶丽仪-上海滩
滔滔江水	叶丽仪	笑迎人生
红颜 (Live)	叶丽仪	叶丽仪45年香港情演唱会
玫瑰玫瑰我爱你	叶丽仪	想念依旧（第1辑）
肝胆相照	叶丽仪	笑迎人生
愿你待我真的好	叶丽仪	多一点精选集 (二) : 叶丽仪-上海滩
长相忆	叶丽仪	仙鹤神针 电影原声带
时间都去哪儿了	王铮亮	爱的自选
只是没有如果	张靓颖|王铮亮	只是没有如果
错过	王铮亮	听得到的时间
热爱整个世界	王铮亮	热爱整个世界
默认	王铮亮	咱们结婚吧 电视剧原声带
越走越远的旅客	王铮亮	那年青春我们正好 电视剧原声带
还在这里	王铮亮	还在这里
以爱之名	王铮亮	以爱之名
相爱一场	王铮亮	前任2：备胎反击战 电影原声带
最远的距离	王铮亮	最远的距离
Say Yes	王铮亮	Say Yes
Together	王铮亮	故事岛
当我们	王铮亮	前任2：备胎反击战 电影原声带
还好	王铮亮	空
我想和你走下去	王铮亮	我想和你走下去
只愿你好	王铮亮	只愿你好
星月	王铮亮	星月
你是我的	王铮亮	爱的自选
真爱你的云	王铮亮	爱的自选
数到三，一起放手	王铮亮	爱的自选
晴天 (Live)	关诗敏	全球中文音乐榜上榜
恋人未满 (Live)	关诗敏	梦响新歌声-上海站
好好说再见	陶喆|关诗敏	再见你好吗
别说	关诗敏	绽放2.0
时间煮雨	关诗敏	空
风之恋	关诗敏	风之恋
一个人也可以幸福	关诗敏	绽放2.0
屋顶 (Live)	陶喆|关诗敏	全能星战 总决赛第一场
不远的情人	关诗敏	不远的情人
放过自己	关诗敏	第四季好声音学员大碟—周杰伦组
魔法爱情	关诗敏	关在家
心动了	关诗敏	绽放2.0
来得及说再见	关诗敏	来得及说再见
Luv Me Luv Me 要说出来	关诗敏	绽放2.0
天气预报	关诗敏	关在家
渴望	关诗敏	渴望
晴天 (铃声)	关诗敏	
我是真的爱你	关诗敏	 
晴天 (2015中国好声音第四季第四期现场版伴奏)	关诗敏	 
快递甜心	关诗敏	关在家
刚好遇见你	李玉刚	刚好遇见你
新贵妃醉酒	李玉刚	新贵妃醉酒
清明上河图	李玉刚	新贵妃醉酒
雨花石	李玉刚	雨花石·坚强的石头
菩提	李玉刚	菩提
水墨丹青	李玉刚	新贵妃醉酒
女儿情	李玉刚	游园惊梦
独孤天下	李玉刚	独孤天下 电视剧影视原声
霸王别姬	李玉刚	镜花水月
陌上风雅	李玉刚	陌上风雅
梨花颂	李玉刚	镜花水月
国色天香	李玉刚	国色天香
枉凝眉	李玉刚	嫦娥奔月
铁血丹心	李玉刚	空
逐梦令	李玉刚	逐梦令
我只在乎你	李玉刚	空
南飞雁	李玉刚	新贵妃醉酒
莲花	李玉刚	莲花
花魁	李玉刚	花魁
霓裳羽衣舞	李玉刚	镜花水月
就是爱你	陶喆	太平盛世
爱，很简单	陶喆	David Tao 同名专辑
小镇姑娘	陶喆	I'm OK
Melody	陶喆	黑色柳丁
爱我还是他	陶喆	太平盛世
普通朋友	陶喆	I'm OK
流沙	陶喆	David Tao 同名专辑
找自己	陶喆	I'm OK
寂寞的季节	陶喆	Ultrasound 乐之路1997-2003
今天你要嫁给我	蔡依林|陶喆	唯舞独尊 演唱会鲜听版&混音
飞机场的10:30	陶喆	David Tao 同名专辑
一念之间	陶喆	再见你好吗
那个女孩	陶喆	再见你好吗
月亮代表谁的心	陶喆	黑色柳丁
黑色柳丁	陶喆	黑色柳丁
好好说再见	陶喆|关诗敏	再见你好吗
Susan说 (Music鉴赏版)	陶喆	太平盛世
Angel	陶喆	黑色柳丁
二十二	陶喆	黑色柳丁
太美丽	陶喆	太美丽
我是不是你最疼爱的人	潘越云	我是不是你最疼爱的人
痴情不是一种罪过	潘越云	痴情
野百合也有春天	潘越云	潘越云精选辑 (二)
几度夕阳红	潘越云	新曲与精选
天天天蓝	潘越云	天天天蓝
最爱	潘越云	旧爱新欢
谢谢你曾经爱过我	潘越云	唯一潘越云
痴痴的等	潘越云	世间女子
京华烟云 (原声带版)	潘越云	京华烟云
把悲伤留给自己 (Live)	潘越云	梦想星搭档 第6期
哭砂 + 我是不是你最疼爱的人 (Live)	潘越云|李泉	梦想星搭档 总决赛
七重门	潘越云	秋天
你会爱我很久吗	潘越云	我是不是你最疼爱的人
不了情	潘越云	男欢女爱
无言的歌	潘越云	无言的歌
旧爱新欢	李宗盛|潘越云	生命中的精灵
爱的箴言	潘越云	唯一潘越云
梦田 (Live)	潘越云	民歌四十 再唱一段思想起——台北场
是否	周华健|潘越云	大合唱2000
潇洒走一回 (Live)	潘越云	梦想星搭档 第10期
想你的夜	关喆	永远的永远
如果分开我也爱你 (白色情人节版)	关喆	寂寞
领悟	关喆	身边的故事
她不爱我	关喆	身边的故事
想定下来	关喆	寂寞
悟空 (Live)	关喆	我是歌手第四季 第12期: 突围赛
你把我灌醉 (Live)	关喆	梦响新歌声第一季 第13期
没那么简单	关喆	身边的故事
征服	关喆	身边的故事
忘记你我做不到 (Live)	关喆	超级歌单 第11期
重度寂寞	关喆	寂寞
我愿意	关喆	身边的故事
天涯共此时 (Live)	关喆	经典咏流传 第5期
欲言又止	关喆	寂寞
给你的歌	关喆	关·爱
伤痕	关喆	身边的故事
让我一次爱个够 (Live)	关喆	超级歌单 第11期
更好的我们	关喆	足矣
永远的永远	关喆	永远的永远
无畏	关喆	足矣
我对我	蔡依林	我对我
说爱你	蔡依林	看我72变
日不落	蔡依林	特务J
布拉格广场	蔡依林|周杰伦	看我72变
舞娘	蔡依林	舞娘
Play我呸	蔡依林	呸
倒带	蔡依林	城堡
Love Love Love	蔡依林	城堡
看我72变	蔡依林	看我72变
大艺术家	蔡依林	大艺术家
爱情三十六计	蔡依林	城堡
特务J	蔡依林	特务J
柠檬草的味道	蔡依林	城堡
今天你要嫁给我	蔡依林|陶喆	唯舞独尊 演唱会鲜听版&混音
马德里不思议	蔡依林	舞娘
我知道你很难过	蔡依林	J女神 影音典藏精选
花蝴蝶	蔡依林	花蝴蝶
骑士精神	蔡依林|周杰伦	看我72变
许愿池的希腊少女	蔡依林	野蛮游戏
妥协	蔡依林	花蝴蝶
隐形的翅膀 (Live)	张韶涵	尖叫卡拉秀第二季 第1期
梦里花 (Live)	张韶涵	尖叫卡拉秀第二季 第1期
欧若拉	张韶涵	欧若拉
阿刁 (Live)	张韶涵	歌手第二季 第2期
淋雨一直走	张韶涵	有形的翅膀
隐形的翅膀	张韶涵	潘朵拉
亲爱的，那不是爱情	张韶涵	Ang 5.0
快乐崇拜	潘玮柏|张韶涵	WuHa
追梦赤子心 (Live)	张韶涵	歌手第二季 第9期
遗失的美好	张韶涵	Over The Rainbow
梦里花	张韶涵	梦里花
寓言	张韶涵	Over The Rainbow
看得最远的地方	张韶涵	非常完美 电影原声带
香水百合	张韶涵	潘朵拉
全世界失眠 (Live)	张韶涵	歌手第二季 第3期
漫步云端 (Live)	张韶涵	歌手第二季 第11期
来过我生命的你 (Live)	张韶涵	歌手第二季 第5期
有形的翅膀	张韶涵	有形的翅膀
不想懂得	张韶涵	Ang 5.0
追梦人 (Live)	张韶涵	歌手第二季 第7期
我曾用心爱你	潘美辰	Sampler
我想有个家	潘美辰	是你
是你	潘美辰	伤感金曲珍藏版
为何爱情让我痛	潘美辰	我可以为你挡死
写不完的爱	潘美辰	珍惜今昔
不要走不要走	潘美辰	伤感情歌
放弃你是我的错	潘美辰	空
只要一丝温柔	潘美辰	伤感金曲珍藏版
教我怎么不想你	潘美辰	创作辑3
不懂爱的人	潘美辰	Cinepower
我不在乎	潘美辰	伤感情歌
心痛的伤口	潘美辰	伤感金曲珍藏版
其实我好想有人陪	潘美辰	我可以为你挡死
我怕我不是你最爱的人	潘美辰	创作辑3
沧海桑田	潘美辰	伤感金曲珍藏版
只想一生跟你走	潘美辰	谁让我流泪
舍不得你离去	潘美辰	伤感情歌
用我的心我的情感动你	潘美辰	珍惜今昔
一生托给一个人	潘美辰	我可以为你挡死
挪威的森林	潘美辰	傻小孩
爱情诺曼底	黄征	爱情诺曼底
绝不放手	黄征	绝不放手
你是另一个我	黄征	神犬奇兵 电视剧原声带
奔跑	黄征	爱情诺曼底
地铁	黄征	一个人的战役
一个人的战役	黄征	一个人的战役
爱,值得	黄征	爱情诺曼底
爱情傻瓜	黄征	绝不放手
一无所有时爱你的人 (国语)	黄征	征爱·拾力
春梦	黄征	春梦
茶花女爱上毕加索	黄征	爱情诺曼底
壮志豪情 (国语)	黄征	征爱·拾力
平行线	黄征	爱情诺曼底
破晓	黄征	破晓
当你从我眼中离开	黄征	破晓
小气鬼	黄征	爱情诺曼底
信仰	黄征	信仰
归来	黄征	归来
比爱更爱	黄征	爱情诺曼底
前生 今日 来世	黄征	北京不孤单
在那桃花盛开的地方	蒋大为	蒋大为独唱歌曲选
牡丹之歌	蒋大为	蒋大为
最美的歌儿唱给妈妈	蒋大为	最美的歌儿唱给妈妈
敢问路在何方	蒋大为	蒋大为珍藏版
骏马奔驰保边疆	蒋大为	骏马奔驰保边疆
北国之春	蒋大为	蒋大为独唱精选
有一个美丽的传说	蒋大为	蒋大为
驼铃	蒋大为	20世纪中华歌坛名人百集珍藏版
十五的月亮	蒋大为	民歌电影歌曲
草原上升起不落的太阳	蒋大为	民歌电影歌曲
九九艳阳天	蒋大为	北国之春
乌苏里船歌	蒋大为	蒋大为珍藏版
敖包相会	蒋大为	民歌电影歌曲
桃花依旧笑春风	蒋大为	共和国的旗帜
跑马溜溜的山上	蒋大为	民歌电影歌曲
送别	蒋大为	民歌电影歌曲
草原之夜	蒋大为	蒋大为珍藏版
大坂城的姑娘	蒋大为	跨世纪艺术瑰宝
骏马奔腾保边疆	蒋大为	空
又是一年桃花开	蒋大为	又是一年桃花开
拯救	孙楠	缘分的天空
留什么给你	孙楠	我们都是伤心人
你快回来	孙楠	南极光
风往北吹	孙楠	南极光
美丽的神话	孙楠|韩红	忘不了你
只要有你	那英|孙楠	少年包青天 电视剧原声带
缘分的天空	孙楠	缘分的天空
不见不散	孙楠	南极光
红旗飘飘	孙楠	生生世世
I Believe	孙楠	缘分的天空
爱你爱不够	孙楠	痛快
净土	孙楠	木府风云 电视剧原声带
是否爱过我	孙楠	第一楠主角
贝加尔湖畔	孙楠	空
漂洋过海来看你 (Live)	萧敬腾|陶喆|孙楠	最美和声第二季 第2期
千秋	孙楠	千秋
留什么给你	孙楠	认识孙楠
传奇	孙楠	第一楠主角2011
新的天地	孙楠	新的天地
无愧于心	孙楠	超级楠声
爱情抗体	许慧欣	万中选一 (新歌+精选)
七月七日晴	许慧欣	美丽的爱情
孤单芭蕾	许慧欣	孤单芭蕾
威尼斯迷路	许慧欣	谜
恋爱频率	许志安|许慧欣	我还能爱谁
忽然很想你	许慧欣	孤单芭蕾
Tell Me	潘玮柏|许慧欣	玻璃情缘 (对唱篇) Vol.One
诗水蛇山神庙	许慧欣	谜
幸福的味道	许慧欣	孤单芭蕾
心动心痛	许慧欣	彩虹天堂
大风吹	许慧欣	幸福
特别来宾	许慧欣|潘玮柏	孤单芭蕾
一个人唱歌	许慧欣	欣·进化
陪你等天亮	许慧欣	谜
两个人的下雪天	许慧欣	快乐为主
独立宣言	许慧欣	美丽的爱情
爱情轮廓	许慧欣	万中选一 (新歌+精选)
纯属意外	许慧欣	欣的记忆
泪水的尽头	许慧欣	欣·进化
流星下的愿 (Live)	张学友|许慧欣	雪狼湖 创意音乐剧国语版
倾国倾城	熊汝霖	空
一如既往	熊汝霖	天下无敌
自由自在	熊汝霖	天下无敌
生而倔强	熊汝霖	生而倔强
送福星 (男生版)	熊汝霖	送福星
相见欢	熊汝霖|姚贝娜	飞行大道
最美的意外	熊汝霖	最美的意外
熊不再出没，请注意！	熊汝霖	熊不再出没，请注意！
it's my life	熊汝霖	 
天下无敌	熊汝霖	天下无敌
Singing In The Rain	熊汝霖	爵士熊 汝霖
熊的狂想曲	熊汝霖	天下无敌
面朝大海 春暖花开	熊汝霖	飞行大道
Mack The Knife (Live)	熊汝霖	中国最强音 第3期
Thank you for loving me	熊汝霖	天下无敌
Get Over It	熊汝霖	梦想中国 巅峰之作 EP
最近的远方	熊汝霖	最近的远方
自由	熊汝霖	Freedom.自由
Beat It	熊汝霖	爵士熊 汝霖
What A Wonderful World (Live)	熊汝霖	围炉音乐会 第27期
春天的芭蕾	常思思	春天的芭蕾
玛依拉变奏曲	常思思	5sing原创音乐精选
注定	常思思	秦时丽人明月心 电视剧原声带
唱支山歌给党听	常思思	红
问春	常思思	常思思精选歌曲集
我爱我的祖国	常思思	春天的芭蕾
听海	常思思	常思思精选歌曲集
军港之夜	常思思	红
这片海有我	常思思	春天的芭蕾
江山	常思思	红
英雄赞歌	常思思	红
情深谊长	常思思	红
红太阳照边疆	常思思	红
阿瓦人民唱新歌	常思思	红
思源	常思思	春天的芭蕾
汉服青史	常思思	汉服青史
彩云阳光	常思思	彩云阳光
因为有你 (Live)	祖海|常思思	2011年春节联欢晚会歌曲
最美中国	常思思|费玉清	最美中国
南泥湾	常思思	红
每一步	徐小凤	每一步
顺流逆流	徐小凤	徐小凤金曲精选
风的季节	徐小凤	新曲与精选
明月千里寄相思	徐小凤	别亦难
漫漫前路	徐小凤	夜风中
别亦难	徐小凤	别亦难
南屏晚钟	徐小凤	别亦难
今宵多珍重	徐小凤	别亦难
风雨同路	徐小凤	环球一双情缘系列-徐小凤
天涯歌女	徐小凤	别亦难
心恋	徐小凤	别亦难
浪子心声	徐小凤	真经典 - 徐小凤
一生所爱	徐小凤	一生所爱
花好月圆 (Live)	徐小凤	金光灿烂徐小凤87演唱会 [升级版]
分飞燕	徐小凤	金光灿烂 徐小凤
何日君再来	徐小凤	一幅画
问情	徐小凤	一幅画
不了情	徐小凤	别亦难
月光小夜曲	徐小凤	别亦难
城市足印	徐小凤	环球2000超巨星系列 - 徐小凤
潇洒走一回	叶倩文	潇洒走一回
曾经心痛	叶倩文	真心真意过一生
祝福	叶倩文	祝福
真心真意过一生 (潇洒自在版)	叶倩文	真心真意过一生
情人知己	叶倩文	红尘
选择	叶倩文	祈望
珍重	叶倩文	珍重
爱上一个不回家的人	叶倩文	Inside Out
秋去秋来	叶倩文	华纳超极品音色系列 - 叶倩文
爱的可能	叶倩文	Inside Out
哭砂	叶倩文	真心真意过一生
酒干倘卖无 (Live)	叶倩文	港乐×叶倩文 Sally Yeh HKPO Live
我是不是你最疼爱的人	叶倩文	Inside Out
伤逝	叶倩文	你听到
其实你不懂我的心	叶倩文	真心真意过一生
驿动的心	叶倩文	真心真意过一生
红尘	叶倩文	红尘
焚心以火 (粤语)	叶倩文	华纳超极品音色系列 - 叶倩文
无言的结局	叶倩文	空
潇洒走一回	叶倩文	金曲廿载情第二十届十大中文金曲
特别的爱给特别的你	伍思凯	特别的爱给特别的你
爱与愁	伍思凯	金曲百分百（上）
爱要怎么说	伍思凯	爱，要怎么说
我真的很不错	伍思凯	我真的很不错
情网	伍思凯	心动了
寂寞公路	伍思凯	特别的爱给特别的你
特别的爱给特别的你 (Live)	张信哲|伍思凯	围炉音乐会 第16期
爱的钢琴手 (Live)	伍思凯	围炉音乐会 第16期
不要再提我的名字	伍思凯	特别的爱给特别的你
分享 (Live)	伍思凯	围炉音乐会 第34期
等着你爱着你	伍思凯	等着你爱着你
爱你一世到来生	伍思凯	不同
且行且珍惜	伍思凯	金曲重炫-3
不只是朋友	伍思凯	心动了
分别以后才懂得拥有	伍思凯	特别的爱给特别的你
想念	伍思凯	创作自选辑
爱与愁 + 过火 (Live)	伍思凯	我为歌狂 第11期
我们之间	伍思凯	特别的爱给特别的你
一生中最爱	谭咏麟	神话1991
谁懂	伍思凯	少年张三丰
短发	梁咏琪	短发
胆小鬼	梁咏琪	梁咏琪 同名专辑
中意他	梁咏琪	新鲜
原来爱情这么伤	梁咏琪	给自己的情歌
花火 (粤语)	梁咏琪	花火
爱的代价	梁咏琪	最爱梁咏琪
错过	梁咏琪	礼物
向左走向右走	梁咏琪	顺时针
新鲜	梁咏琪	新鲜
花火 (国语)	梁咏琪	Amour
凹凸	梁咏琪	透明
爱得起	梁咏琪	礼物
天使与海豚	梁咏琪	Amour
Today	梁咏琪	Today
有时候	梁咏琪	洗脸
我钟意	梁咏琪	Today
偏见	梁咏琪	顺时针
月半小夜曲 (Live)	梁咏琪|李克勤	903拉阔音乐会2002
我只在乎你	梁咏琪	短发
灰姑娘	梁咏琪	花火
找一个字代替	邰正宵	找一个字代替
千纸鹤	邰正宵	千纸鹤
心要让你听见	邰正宵	一千零一夜
一千零一夜	邰正宵	一千零一夜
九百九十九朵玫瑰	邰正宵	找一个字代替
好人好梦	邰正宵	情歌对唱大集合
用情太深	邰正宵	一千零一夜
心太冷 梦太真	邰正宵	一千零一夜
想你想得好孤寂	邰正宵	千纸鹤
山水画	邰正宵	山水画
爱归零	邰正宵	爱归零
情人之间的情人	邰正宵	找一个字代替
相思如麻	邰正宵	相思如麻
纸飞机 (国语)	邰正宵	再等一百年
爱的传说	邰正宵	用情太深
泪流一千遍	邰正宵	我不配
寸寸相思寸寸心	邰正宵	重燃爱恋
我的心在冷风里飞 (千纸鹤~深情摇滚版)	邰正宵	重燃爱恋
好人好梦	邰正宵	大家一起来
我怎么舍得你哭	邰正宵	找一个字代替
难得有情人	关淑怡	难得有情人
深夜港湾	关淑怡	"EX" All Time Favourites
缱绻星光下	关淑怡	My Way
地尽头	关淑怡	Shirley’s Era
明天你是否依然爱我	谭咏麟|关淑怡	神话1991
星空下的恋人	关淑怡	难得有情人
地老天荒	关淑怡	金色夏季
梦伴	关淑怡	世途上
忘记他	关淑怡	环球DSD视听之王 - 关淑怡
难得有情人 (国语)	关淑怡	难得有情人
一切也愿意	关淑怡	环球一双情缘系列 - 关淑怡
一首独唱的歌	关淑怡	环球一双情缘系列 - 关淑怡
年少无情	张学友|关淑怡	梦中的你
只想您会意	李克勤|关淑怡	只想您会意
情深爱更深	关淑怡	永远爱着您
问	张学友|关淑怡	友情对唱
无尽的爱	关淑怡	环球一双情缘系列 - 关淑怡
双星情歌	关淑怡	环球一双情缘系列 - 关淑怡
只得一次	关淑怡	Shirley’s Era
忘记他	关淑怡	堕落天使
断点	张敬轩	My Way
吻得太逼真	张敬轩	Urban Emotions
只是太爱你	张敬轩	P.S. I Love You
春秋	张敬轩	No. Eleven
樱花树下	张敬轩	Urban Emotions
酷爱	张敬轩	酷爱
囍帖街	张敬轩	Dahlia II
可惜我是水瓶座	张敬轩	Dahlia II
不吐不快	张敬轩	Urban Emotions
My Way	张敬轩	我的梦想我的路
骚灵情歌	张敬轩	笑忘书
黄色大门	张敬轩	Dahlia II
尘埃落定	张敬轩	是时候…
绝	张敬轩	Dahlia II
笑忘书	张敬轩	笑忘书
好心分手	张敬轩	Dahlia II
无能为力	张敬轩	A.m./ P.m.
灵魂相认	张敬轩	Morph
爱的故事上集 (Live)	张敬轩	轩动心弦演唱会
青春常驻	张敬轩	青春常驻
我的眼里只有你	景岗山	我的眼里只有你
兄弟无数	景岗山	新水浒传
守业更比创业难	景岗山	空
步步高	景岗山|林依轮	空
寂寞是因为思念谁	景岗山	校园民谣 1
我的眼中只有你	景岗山	2011快乐女声四进三
中国山	景岗山	十月围城 电视剧原声带
我知道你在等着我	景岗山	我知道你在等着我
策马啸西风	景岗山	空
我是不是还能爱你	景岗山	我是不是还能爱你
红豆	景岗山	心声
因为我是男人	景岗山	山山来迟
一天成永远	景岗山	山山来迟
重新再来	景岗山	我是不是还能爱你
山里的汉子	景岗山	中国巨星首唱原版
人人都热爱迪斯科	景岗山	心声
爱你几回不流泪	景岗山	我是不是还能爱你
你有一种惊心动魄的美	景岗山	我是不是还能爱你
多少年以后你懂	景岗山	山山来迟
分手的街	景岗山	心声
都是夜归人	许美静	都是夜归人
遗憾	许美静	遗憾
城里的月光	许美静	遗憾
放你在心里	许美静	静听精彩13首
阳光总在风雨后	许美静	都是夜归人
倾城	许美静	静听精彩13首
明知故犯	许美静	静听精彩13首
蔓延	许美静	蔓延
荡漾	许美静	快乐无罪
铁窗	许美静	遗憾
你抽的烟	许美静	Review 1996-1999精选辑
快乐无罪	许美静	快乐无罪
边界1999	许美静	快乐无罪
迷乱	许美静	都是夜归人
放在你心里	许美静	都是夜归人
只是这人生	许美静	都是夜归人
倾城	许美静	国语真经典
迫在眉梢	许美静	静电
一场朋友	许美静	一场朋友
萍聚 (Live)	李翊君|许茹芸|许美静	争奇斗艳演唱会实况
爱一点 (Live)	莫艳琳	金钟奖中国音超 第8期
别了，耳听爱情的年纪	莫艳琳	说走就走
带走 (Live)	莫艳琳	QQ音乐巅峰对决 冠军之夜
我不能哭	莫艳琳	我不能哭
爱一点	王力宏	你的爱。
平凡之路 (Live)	莫艳琳	QQ音乐巅峰对决 第1期
看海	莫艳琳	看海
过火	莫艳琳	宅情歌
醒来再做梦	莫艳琳	说走就走
亲爱的 你会想我吗	莫艳琳	我不能哭
好久不见 (Live)	莫艳琳	莫艳琳现场版
风吹麦浪 (铃声)	莫艳琳	
带走 (DJ花无心版)	莫艳琳	 
错的是我	莫艳琳	说走就走
爱一点		空
你的背包 (铃声)	莫艳琳	
天蝎和处女	莫艳琳	说走就走
爱一点 (DJ版)	莫艳琳	 
黑白电影 (Live)	莫艳琳	莫艳琳现场版
失眠症	莫艳琳	我不能哭
值得	郑秀文	值得
唉声叹气	郑秀文	我们的主题曲
终身美丽	郑秀文	郑秀文极品精选
独一无二	郑秀文	完整Complete
眉飞色舞	郑秀文	2002电Party
出界	郑秀文	我应该得到
默契	郑秀文	浓情
不拖不欠	郑秀文	放不低
煞科	郑秀文	Ladies First
信者得爱 (Live)	郑秀文	爱 Love Mi 郑秀文世界巡回演唱会香港站LIVE
爱的挽歌	郑秀文	舍不得你
终身美丽	郑秀文	Shocking Pink
插曲	郑秀文	多谢·新曲+精选
唯独你是不可取替	郑秀文	Sammi VS Sammi
为何又是这样错	郑秀文	生活语言
信者得爱	郑秀文	信者得爱
如何掉眼泪	郑秀文	爱是… Love Is …
独家试唱	郑秀文	爱是… Love Is …
放不低	郑秀文	放不低
理想对象	郑秀文	Feel So Good
3170	曹方	3170
认真地老去	曹方	认真地老去
面包	曹方	3170
遇见我	曹方	遇见我
比天空还远	曹方	比天空还远
飘起来的房子和勇士	曹方	飘起来的房子和勇士
我的北京	曹方	3170
南部小城	曹方	哼一首歌 等日落
明白	曹方	3170
风吹过下雨天	曹方	遇见我
决定	曹方	3170
等人	曹方	哼一首歌 等日落
城市稻草人	曹方	遇见我
在	曹方	3170
冰川	曹方	Wanderlust·流浪癖
被拥抱的荒岛	曹方	被拥抱的荒岛
想把我唱给你听	曹方	我们都是好孩子
春花秋开	曹方	黑色香水
我是认真的	曹方	哼一首歌 等日落
最小的海	曹方	比天空还远
痴心绝对	李圣杰	痴心绝对
手放开	李圣杰	绝对痴心.手放开
你那么爱她	李圣杰	Men's Talk About Love
最近	李圣杰	关于你的歌
关于你的歌	李圣杰	关于你的歌
你那么爱她	李圣杰	音乐十年李圣杰唯一精选
说散就散 (Live)	李圣杰	歌手第二季 第12期
每次都想呼喊你的名字 (Live)	李圣杰	梦想的声音 第7期
离人 (Live)	李圣杰	歌手第二季 第3期
You And I (Live)	李圣杰	歌手第二季 第1期
不顾一切的爱	李圣杰	绝对痴心.手放开
擦肩而过	李圣杰	收放自如
安静 (Live)	李圣杰	歌手第二季 第4期
如果你爱他	李圣杰	痴心绝对
远走高飞	李圣杰	绝对痴心.手放开
我以为	李圣杰	关于你的歌
眼底星空	李圣杰	关于你的歌
听说	李圣杰	听说
你那么爱她	李圣杰	关于你的歌
位置	李圣杰	绝对痴心.手放开
手掌印	江若琳	Love TV 情歌精选2
原来我还爱着你	江若琳	江若琳 最好的时光
错爱	江若琳	Shining
眼泪无用	江若琳	Shining
太早	江若琳	首张国语大碟
最好的时光	江若琳	江若琳 最好的时光
伤情路	江若琳	Innocent
你不在了	江若琳	Shining
你给我力量	江若琳	天空之树
爱你还是爱美	江若琳	Shining
勇敢爱	江若琳	江若琳 最好的时光
Love Love Love	江若琳	首张国语大碟
旁观者伤	江若琳	旁观者伤
爱无可忍	江若琳	Show You
童话	江若琳	空
撒娇	江若琳	Innocent
One And Only	江若琳	One And Only
新不了情 (Live)	江若琳	My First Show 2010演唱会
太早 (铃声)	江若琳	
Show You	江若琳	Show You
活着	郝云	活着
去大理	郝云	心花路放 电影原声带
突然想到理想这个词	郝云	突然想到理想这个词
结了	郝云	突然想到理想这个词
如果来生还能遇见你	郝云	活着
该装就装	郝云	活着
北京 北京	郝云	北京
群发的我不回	郝云	群发的我不回
回到那一天	郝云	突然想到理想这个词
四季不败	郝云	四季不败
卖艺的小青年	郝云	突然想到理想这个词
一声叹息	郝云	活着
逃跑的木偶	郝云	突然想到理想这个词
如果生命只剩最后一天	郝云	活着
这个城市	郝云	北京
情谣	郝云	突然想到理想这个词
姥姥说	郝云	姥姥说
天马行空	郝云	活着
五百万	郝云	突然想到理想这个词
买还私奔的	郝云	活着
约定	周蕙	周蕙精选
好想好好爱你	周蕙	周蕙精选 2 好想好好爱你
风铃	周蕙	周蕙精选
不想让你知道	周蕙	周蕙精选
相遇太早	周蕙	周蕙精选 2 好想好好爱你
不爱了也是一种爱	周蕙	自己的房间
替身	周蕙	周蕙精选 2 好想好好爱你
话题	周蕙	周蕙精选 2 好想好好爱你
味道 (Live)	周蕙|许志安	蒙面唱将猜猜猜 第2期
爱的箴言 (Live)	周蕙	蒙面唱将猜猜猜 第3期
情人 (Live)	周蕙	蒙面唱将猜猜猜 第2期
寂寞城市	周蕙	周蕙精选3 寂寞城市
相思风雨中 (Live)	许志安|周蕙	蒙面唱将猜猜猜 第11期
预言	周蕙	周蕙精选
思念的翅膀	周蕙	周蕙精选
今宵多珍重	周蕙	今宵多珍重
事到如今	周蕙	周蕙精选 2 好想好好爱你
我喜欢	周蕙	周蕙精选
该忘了你对不对	周蕙	绽放
体温	周蕙	周蕙精选3 寂寞城市
我要我们在一起	范晓萱	我要我们在一起
我爱洗澡	范晓萱	小魔女的魔法书2 魔登家庭
雪人	范晓萱	好想谈恋爱
健康歌	范晓萱	冰淇淋的祈祷
氧气 (O1缺氧版)	范晓萱	Darling
小叮当	范晓萱	小魔女的魔法书
眼泪	范晓萱	自言自语
稍息立正站好	范晓萱	冰淇淋的祈祷
你的甜蜜	范晓萱	自言自语
深呼吸	范晓萱	Rain
哭了	范晓萱	Darling
豆豆龙	范晓萱	小魔女的魔法书
Rain	范晓萱	Rain
同步	范晓萱	同步
刷牙歌	范晓萱	小魔女的魔法书2 魔登家庭
管他什么音乐	范晓萱	赤子
那种女孩	范晓萱	突破
自言自语	范晓萱	自言自语
消失	范晓萱	好想谈恋爱
我喜欢这样的安静	范晓萱	自言自语
三月里的小雨	刘文正	最爱情歌80
雨中即景	刘文正	兰花草
童年	刘文正	80年代巨星再现
迟到	刘文正	却上心头
阿美阿美	刘文正	阿美!阿美!
梅兰梅兰我爱你	刘文正	兰花草
恰似你的温柔	刘文正	80年代-巨星再现 vol.2
相思河畔	刘文正	兰花草
兰花草	刘文正	国语精选辑1-刘文正
外婆的澎湖湾	刘文正	国语精选辑1-刘文正
小秘密	刘文正	三月里的小雨
耶利亚女郎	刘文正	太阳一样
送你一朵勿忘我	刘文正	金曲精选
多少柔情多少泪	刘文正	金装刘文正不朽经典金曲
闪亮的日子	刘文正	走过岁月6CD传家典藏
爱像什么	刘文正	太阳一样
诺言	刘文正	诺言
太阳一样	刘文正	太阳一样
散场	刘文正	三月里的小雨
热线你和我	刘文正	太阳一样
太傻 (Live)	巫启贤	2018围炉音乐会 第2期
思念谁	巫启贤	思念谁
爱那么重 + 我感觉不到你 + 爱情傀儡 + 只因你伤心 (Live)	巫启贤	2018围炉音乐会 第2期
人生如梦 (Live)	巫启贤	2018围炉音乐会 第2期
别以为男人就不会哭 (Live)	巫启贤	2018围炉音乐会 第2期
为了你 (Live)	巫启贤	2018围炉音乐会 第2期
红尘来去一场梦	巫启贤	红尘来去一场梦
爱那么重	巫启贤	爱那么重
等你等到我心痛	巫启贤	等你等到我心痛
只因你伤心	巫启贤	宝丽金30年精选集
太傻 (粤语)	巫启贤	心酸的情歌
用心良苦 (Live)	巫启贤	巫启贤风中有情演唱会
想着你的感觉	巫启贤	伤心情话·想着你的感觉
心酸的情歌	巫启贤	心酸的情歌
爱情傀儡	巫启贤	爱情傀儡
你是我的唯一	巫启贤	太傻（情歌回顾展）
我没有钱我不要脸	巫启贤	寻贤启事 新选辑
团圆	巫启贤	巨星城2000-2001惊选集
只想一生跟你走 (Live)	巫启贤	Back To Innocence 重回演唱会
不凡初心	巫启贤	不凡初心
用心良苦 (Live)	周华健	嗨，唱起来  第10期
爱相随 (Live)	周华健	嗨，唱起来  第10期
传奇 (Live)	周华健	嗨，唱起来  第10期
凡人歌 (Live)	周华健	嗨，唱起来  第10期
风雨无阻	周华健	风雨无阻
难念的经	周华健	生·生活
花心	周华健	花心
让我欢喜让我忧	周华健	让我欢喜让我忧
有没有一首歌会让你想起我	周华健	忘忧草
刀剑如梦 (国语)	周华健	风雨无阻
其实不想走	周华健	风雨无阻
朋友	周华健	朋友
孤枕难眠	周华健	花心
天下有情人	周华健	爱相随
神话情话 (粤语)	周华健	中港台电视剧主题曲大比拼
亲亲我的宝贝	周华健	不愿一个人
漂洋过海来看你 (Live)	李宗盛|周华健	空
忘忧草	周华健	忘忧草
江湖笑 (独唱版)	周华健	雨人
最真的梦	周华健	最真的梦
现代爱情故事	许秋怡	EMI星声传集之张智霖
偷偷想你	许秋怡	秋怡
片片枫叶情	许秋怡	天地男儿超级精选
难得有情人	许秋怡	现代爱情故事
分手	许秋怡	天地男儿超级精选
抱紧我心	许秋怡	现代爱情故事
梦断	许秋怡	现代爱情故事
悲欢离合	许秋怡	现代爱情故事
温馨的目光	许秋怡	现代爱情故事
现代爱情故事	许秋怡	飞图20周年纪念精选大碟
偷偷想你	许秋怡	真心精选
爱至死不休	许秋怡	现代爱情故事
夜雨打痛我心	许秋怡	秋怡
盼可有日再遇	许秋怡	秋怡
似梦似真	许秋怡	秋怡
夕阳之恋	许秋怡	秋怡
爱上一个爱我也爱她的人	许秋怡	Colour Of Love
相恋多一次	许秋怡	秋怡
一首曾共你爱过的歌	许秋怡	秋怡
片片枫叶情		爱在创意的日子
坏天使 (Live)	江映蓉	“饺子捞起来•我包”2016媒体融合过年秀
把握你的美 (Live)	江映蓉	跨年演唱会2012-2013 华语篇1
3 2 1 Fight	江映蓉	3 2 1 Fight
以人民的名义	江映蓉	以人民的名义
坏天使2.1	江映蓉	坏天使2.1
闪闪惹人爱 & PARTY Rock Anthem (Live)	江映蓉	快乐男声2013 总决赛
漂亮	江映蓉	漂亮
当 (Live)	江映蓉	梦想星搭档 第8期
Love Magic	江映蓉|张杰	手牵手
表白 (Live)	江映蓉	空
热门花招 (Live)	江映蓉	湖南卫视2012跨年演唱会
Beautiful Light	江映蓉	Beautiful Light
Poker Face (Live)	江映蓉	空
爱情鸟	江映蓉	 
Beautiful Light (铃声)	江映蓉	
最爱的人伤我最深 (铃声)	江映蓉	
Crazy (KTV版伴奏)	江映蓉	 
歌曲串烧 (Live)	江映蓉	跨年演唱会2012-2013 华语篇1
姐,你睡了吧 (铃声)	江映蓉	
遇见 (Live)		 
涛声依旧	毛宁	请让我的情感留在你身边
晚秋	毛宁	晚秋
心雨	毛宁|杨钰莹	能有几次这样的爱
我悄悄地蒙上你的眼睛	毛宁|杨钰莹	金童玉女浓情对唱
蓝蓝的夜蓝蓝的梦	毛宁	毛宁
我是不是该安静的走开	毛宁|杨钰莹	能有几次这样的爱
心雨	杨钰莹|毛宁	能有几次这样的爱
涛声依旧 (Live)	毛宁	音乐大师课 第4期
是否还会想起我	毛宁	晚秋
等你在老地方	毛宁	涛声依旧 陈小奇十年经典金曲选
我是不是该安静地走开	毛宁|杨钰莹	金童玉女浓情对唱
大浪淘沙	毛宁	大浪淘沙
阿哥阿妹情意长	毛宁	K歌单曲合集
心中只有你	毛宁	为了爱
友谊天长地久	杨钰莹|毛宁	空
我心永恒	毛宁	心的毛宁
心雨	毛宁	情歌对唱大集合
涛声依旧 (Live)	毛宁	天下无双
能有几次这样的爱	毛宁|杨钰莹	能有几次这样的爱
我是不是该安静地走开	杨钰莹|毛宁	能有几次这样的爱
两个人 一个人	那英	两个人 一个人
默	那英	默
有个爱你的人不容易	那英	有个爱你的人不容易
白天不懂夜的黑	那英	白天不懂夜的黑
征服	那英	征服
一笑而过	那英	我不是天使
梦一场	那英	干脆
岁月	王菲|那英	岁月
春暖花开 (Live)	那英	精彩音乐汇
雾里看花	那英	但愿好梦都成真
三生三世十里桃花	那英	三生三世十里桃花
只要有你	那英|孙楠	少年包青天 电视剧原声带
相爱恨早	那英	相爱恨早
山不转水转	那英	原唱经典名曲珍藏（10）
不管有多苦	那英	征服
愿赌服输	那英	干脆
酒干倘卖无 (Live)	那英	那英 全经典演唱会
相约一九九八	王菲|那英	终身伴侣
出卖	那英	心酸的浪漫
相见不如怀念	那英	干脆
暧昧	侯湘婷	爱之旅
秋天别来	侯湘婷	你爱我吗
我是一只鱼 (女生版)	侯湘婷	你爱我吗
我是如此爱你 (独唱版)	侯湘婷	17.18.19…
两个冬天	侯湘婷	爱之旅
你爱我吗	侯湘婷	你爱我吗
为你流的泪	侯湘婷	侯湘婷同名专辑
冷战	侯湘婷	你爱我吗
一起去巴黎	侯湘婷	爱之旅
风晓得	侯湘婷	你爱我吗
昨天今天明天	侯湘婷	17.18.19…
你要好好的	侯湘婷	你要好好的
原来的你	侯湘婷	侯湘婷同名专辑
都是真的	侯湘婷	侯湘婷同名专辑
I'll Marry You	侯湘婷	17.18.19…
一个人的星期天	侯湘婷	爱之旅
秋天以后的故事	侯湘婷	爱之旅
离开爱的日子	侯湘婷	侯湘婷同名专辑
真夏的公车	侯湘婷	你爱我吗
我是如此爱你 (对唱版)	侯湘婷	17.18.19…
那女孩对我说	黄义达	专属密码
显微镜下的爱情	黄义达	无法定义
一秒的安慰	黄义达	专属密码
写给自己的歌	黄义达	写给自己的歌
蓝天	黄义达	无法定义
Broken heart	黄义达	微光
专属密码	黄义达	专属密码
微光	黄义达	微光
匿名的宝贝	黄义达	无法定义
目击者	黄义达	专属密码
保留	黄义达	微光
Set Me Free III	黄义达	Heart Disk
我懂	黄义达	完整演出
如果爱 就现在吧	黄义达	专属密码
爱了才懂	黄义达	写给自己的歌
我不哭	黄义达	Heart Disk
每天的每夜	黄义达	专属密码
喜欢你（喜欢我）	黄义达	无法定义升级版
老情歌	黄义达	Heart Disk
那女孩	黄义达	完整演出
滚滚长江东逝水	杨洪基	震撼·滚滚长江东逝水
向天再借五百年	杨洪基	震撼·滚滚长江东逝水
滚滚长江东逝水 (Live)	杨洪基	经典咏流传 第1期
莫斯科郊外的晚上	杨洪基	多彩的歌声（9）
雁南飞	杨洪基	震撼·滚滚长江东逝水
我和我的祖国	杨洪基	白发·黄沙
美丽的草原我的家	杨洪基	震撼·滚滚长江东逝水
万水千山总是情	杨洪基	震撼·滚滚长江东逝水
三套车	杨洪基	白发·黄沙
多情的土地	杨洪基	白发·黄沙
短歌行	杨洪基	三国演义 电视剧原声带
再回首	杨洪基	震撼·滚滚长江东逝水
满江红	杨洪基	中国民族歌曲经典③
在水一方	杨洪基	震撼·滚滚长江东逝水
伊犁河的月夜	杨洪基	美丽的大海
重整山河待后生	杨洪基	震撼·滚滚长江东逝水
共和国之恋	杨洪基	白发·黄沙
敖包相会	杨洪基	震撼·滚滚长江东逝水
祖国，慈祥的妈妈	杨洪基	百年经典
大海啊故乡	杨洪基	震撼·滚滚长江东逝水
那是你离开了北京的生活	薛之谦	那是你离开了北京的生活
肆无忌惮	薛之谦	肆无忌惮
怪咖	薛之谦	怪咖
哑巴	薛之谦	哑巴
刚刚好	薛之谦	初学者
怪咖 (Live)	薛之谦	无限歌谣季 第10期
你还要我怎样	薛之谦	意外
演员	薛之谦	绅士
醒来 (Live)	薛之谦	无限歌谣季 第6期
绅士	薛之谦	绅士
暧昧	薛之谦	渡 The Crossing
我好像在哪见过你	薛之谦	初学者
意外	薛之谦	意外
天后 (Live)	薛之谦	蒙面唱将猜猜猜第二季 第11期
像风一样	薛之谦	渡 The Crossing
方圆几里	薛之谦	意外
动物世界	薛之谦	渡 The Crossing
丑八怪	薛之谦	意外
摩天大楼	薛之谦	摩天大楼
认真的雪	薛之谦	薛之谦
铁齿铜牙纪晓岚	戴娆	锦上添花
故事就是故事	戴娆	锦上添花
百姓的事儿牵着走	戴娆	锦上添花
绽放	戴娆	绽放
但愿人长久	戴娆	爱情锦囊妙计
念念不忘	屠洪刚|戴娆	中国功夫
爱是仙上仙	戴娆	锦上添花
靠近你, 轻轻说爱你	戴娆	空
思绪如潮	戴娆	思绪如潮
相思	戴娆	空
布衣知县梵如花	戴娆	锦上添花
我爱我家	戴娆	锦上添花
幸福来敲门	戴娆	爱情锦囊妙计
落泪的玫瑰	戴娆	思绪如潮
情纠缠	戴娆	锦上添花
爱你就在一瞬间	戴娆	空
风儿告诉我	戴娆	思绪如潮
爱你, 一年不止三百六十五天	戴娆	空
还是家乡好	戴娆	空
心放飞	戴娆	心放飞
美人吟	李玲玉	美人吟
粉红色的回忆	李玲玉	粉红色的回忆
天竺少女	李玲玉	西游记 电视剧配乐原声
女儿情 (Live)	李玲玉	空
你潇洒我漂亮	李玲玉	粉红色的回忆
无奈的思绪	李玲玉	甜甜甜 台湾甜美情歌精选
是酒也是泪	李玲玉	是否把我忘记2
情网	李玲玉	情网
为了你	李玲玉	甜甜甜 李玲玉甜歌演唱专辑
信天游	李玲玉	午夜街头 (二)
笑红尘 (黄梅戏)	李玲玉	国色天香 第四期
我是不是该安静地走开	李玲玉	美人吟
除了你	李玲玉	甜甜甜 台湾甜美情歌精选
人在旅途	李玲玉	渴望 电视剧原声带
窗外 (Live)	李玲玉	围炉音乐会 第14期
妈妈的吻	李玲玉	星光依然灿烂
敬祝毛主席万寿无疆	李玲玉	歌唱毛泽东 群星颂伟人
爱你真好难	李玲玉	美人吟
采茶舞曲	李玲玉	民歌联唱200首
我曾用心爱着你	李玲玉	卿卿呢语
耿耿于怀	麦浚龙	Walking Underneath
罗生门	麦浚龙	Addendum
念念不忘	麦浚龙	Addendum
如果可以待你好	麦浚龙	Walking Underneath
有人	麦浚龙	Walking Underneath
借火	麦浚龙	Words Of Silence
彳亍	麦浚龙	无念
弱水三千	麦浚龙	天生地梦
瑕疵	麦浚龙|莫文蔚	Addendum
雷克雅未克	麦浚龙	Addendum
蒙	麦浚龙	Nothing Lasts Forever
吃鲸鱼的人	麦浚龙	Words Of Silence
可不可不撑下去	麦浚龙	Words Of Silence
单鱼座	麦浚龙	Addendum
自己保重	麦浚龙	Next Step
禽兽	麦浚龙	禽兽
樱吹雪	麦浚龙	无念
没有人	麦浚龙	Walking Underneath
睡前服	麦浚龙	Addendum
刽子手最后一夜	麦浚龙	Evil is a point of view
梦醒时分	陈淑桦	跟你说 听你说
笑红尘	陈淑桦	东方不败之风云再起 电影原声带
滚滚红尘	陈淑桦	一生守候
问	陈淑桦	爱的进行式
你走你的路	陈淑桦|李宗盛	跟你说 听你说
流光飞舞 (国语)	陈淑桦	青蛇 电影原声带
这样爱你对不对	陈淑桦	聪明糊涂心
明明白白我的心	陈淑桦	第一次
聪明糊涂心	陈淑桦	聪明糊涂心
读你	陈淑桦|李宗盛	空
萍水相逢	陈淑桦|周华健	爱的进行式
滚滚红尘	罗大佑|陈淑桦	港台影视怀旧金曲
说，你爱我	陈淑桦	淑桦盛开FOREVER
生生世世	陈淑桦	生生世世
做个真的我	陈淑桦	烧得厉害
情关	陈淑桦	一生守候
当真就好	张国荣|陈淑桦	挚爱
笑红尘	陈淑桦	滚石九大天王 贺岁齐唱十二出好戏
一生守候	陈淑桦	一生守候
你走你的路	李宗盛|陈淑桦	最爱一生百万纪录巨星精选-世纪合唱
一生爱你千百回	梅艳芳	女人花
夕阳之歌	梅艳芳	In Brasil
女人花	梅艳芳	情牵女人心
似是故人来	梅艳芳	戏剧人生
亲密爱人 (Piano Version)	梅艳芳	亲密爱人
相爱很难	张学友|梅艳芳	他在那里
胭脂扣	梅艳芳	烈焰红唇
风的季节	梅艳芳	追忆似水芳华
下辈子别再做女人	梅艳芳	情牵女人心
孤身走我路	梅艳芳	坏女孩
似水流年	梅艳芳	似水流年
今宵多珍重	梅艳芳	没话说
你把我灌醉	梅艳芳	没话说
烈焰红唇 (粤语)	梅艳芳	烈焰红唇
用心良苦	梅艳芳	没话说
逝去的爱	梅艳芳	飞跃舞台
芳华绝代	张国荣|梅艳芳	I Am What I Am
梦伴	梅艳芳	坏女孩
将冰山劈开	梅艳芳|许志安	妖女
抱紧眼前人	梅艳芳	镜花水月
特别的人	方大同	危险世界
三人游	方大同	橙月
春风吹	方大同	Soulboy
Nothing's Gonna Change My Love For You	方大同	Timeless 可啦思刻
爱爱爱	方大同	爱 爱 爱
红豆	方大同	Timeless 可啦思刻
因为你	方大同	15
每个人都会	方大同	橙月
Love Song	方大同	未来
为你写的歌 (Bonus Track)	方大同	橙月
复刻回忆	方大同	It's My Day
Wonderful Tonight	方大同	Timeless 可啦思刻
四人游	方大同	爱 爱 爱
黑白	方大同	橙月
千纸鹤	方大同	回到未来
关于爱的定义	方大同	回到未来
够不够	方大同	未来
苏丽珍	方大同	爱 爱 爱
悟空	方大同	JTW 西游记（BLACK）
小小虫	方大同	橙月
精忠报国	屠洪刚	精忠报国
你	屠洪刚	我爱
霸王别姬	屠洪刚	原创龙虎榜
江山无限	屠洪刚	精忠报国
中国功夫	屠洪刚	中国功夫
风云	屠洪刚	风云2
藏龙卧虎	屠洪刚	精忠报国
爱人	屠洪刚	精忠报国
孔雀东南飞	屠洪刚	中国功夫
对酒当歌	屠洪刚	中国功夫
龙的传人	屠洪刚	空
风云2	屠洪刚	屠洪刚 作品精选集
我心为谁动	屠洪刚	原唱流行经典名曲（3）
叶问霜天	屠洪刚	叶问 电视剧原声带
独占潇洒	屠洪刚	封神榜 电视剧原声带
我的心	屠洪刚	屠洪刚 作品精选集
莽原	屠洪刚	屠洪刚 作品精选集
龙行天下 (Live)	屠洪刚	北京卫视2018环球跨年盛典晚会
阿里山的姑娘	屠洪刚	民歌联唱200首
唯有兄弟	屠洪刚	屠洪刚 作品精选集
雨蝶	李翊君	誓言谎言
诺言	李翊君	诺言
风中的承诺	李翊君	7情6欲 绝对精彩13首 Best I
多情人把灵魂都给了谁	李翊君	醇经典
永远永远	李翊君	风云 电视剧原声带
七情六欲	李翊君	7情6欲 绝对精彩13首 Best I
痛	李翊君	誓言谎言
萍聚	李翊君	你那么爱她
漂洋过海来看你	李翊君	李翊君的情歌1天荒地老
花开花落	李翊君	空
沙漠寂寞	李翊君	誓言谎言
最爱最恨都是你	李翊君	你那么爱她
梦醒时分	李翊君	海枯石烂
爱我，你怕了吗	姜育恒|李翊君	爱我你怕了吗？
容易受伤的女人	李翊君	重生
雨蝶 + 泪海 + 往事随风 + 明天的明天 (Live)	李翊君	我为歌狂 第1期
不让我的眼泪陪我过夜	李翊君	翊往情深
红尘	李翊君	勇敢的爱
明天你是否依然爱我	李翊君	暗恋
婉君	李翊君	七情六欲Best II绝对精采13首
谢谢你让我这么爱你	柯以敏	谢谢你让我这么爱你
河流	柯以敏	断了线
太傻	柯以敏	断了线
爱我	柯以敏	爱我
美丽	柯以敏	美丽
人生宛如初相见	柯以敏	那个伤害你的人
她在睡前哭泣	李玟|柯以敏	李玟 同名专辑
断了线	柯以敏	断了线
空船	柯以敏	谢谢你让我这么爱你
爱我 (Yes版)	柯以敏|林志炫	爱我
爱你胜过我自己	柯以敏	精选
我用生命爱你 (中文版)	王力宏|柯以敏	Evolution 音乐进化论
思念是一种惩罚	柯以敏	谢谢你让我这么爱你
拥抱我	柯以敏	拜访 电影版
在秋天醒来	柯以敏	邻居的耳朵
让生命重来	柯以敏	让生命重来
邻居的耳朵	柯以敏	邻居的耳朵
电台情歌 + 水晶 + 爱情 + 如果爱 + 我愿意 (Live)	柯以敏	我为歌狂 第三期
两难	柯以敏	拥抱我
我想有个家	潘美辰|柯以敏	我想有个家
鸭子	苏慧伦	鸭子
Lemon Tree	苏慧伦	Lemon Tree
原来你也在这里 (Live)	苏慧伦	蒙面唱将猜猜猜第二季 第6期
被动	苏慧伦	Lemon Tree
哭过的天空	苏慧伦	Lemon Tree
黄色月亮	苏慧伦	傻瓜
我一个人住	苏慧伦	六月的茉莉梦
相见不如怀念 (Live)	苏慧伦	蒙面唱将猜猜猜第二季 第5期
秋天的海	苏慧伦	恋恋真言
在我生命中的每一天	苏慧伦	东方之珠Ⅱ 在我生命中的每一天
傻瓜	苏慧伦	傻瓜
天下大乱	苏慧伦	滚石香港黄金十年苏慧伦精选
失恋万岁	莫文蔚|苏慧伦	含情莫莫 (全精选辑)
OK? OK!	苏慧伦	鸭子
虎口脱险 (Live)	苏慧伦	蒙面唱将猜猜猜第二季 第5期
原点 (Live)	苏慧伦	蒙面唱将猜猜猜第二季 第6期
相见恨晚	苏慧伦	满足
还剩下什么	苏慧伦	没你不行
不想想太多	苏慧伦	苏慧伦同名专辑
爱你让我勇敢	杜德伟|苏慧伦	原来我爱你那么多(新歌+精选)
没离开过	林志炫	擦声而过 2
烟花易冷 (Live)	林志炫	我是歌手第一季 第6期
单身情歌	林志炫	单身情歌 超炫精选
你的样子	林志炫	一个人的样子
蒙娜丽莎的眼泪	林志炫	蒙娜丽莎的眼泪
离人	林志炫	擦声而过
浮夸 (Live)	林志炫	我是歌手第一季 总决赛
凤凰花开的路口	林志炫	绝对收藏
卷珠帘 (Live)	林志炫	歌手 第8期
输了你赢了世界又如何	林志炫	原声之旅
夜夜夜夜 (Live)	林志炫	我是歌手第一季 第10期
Making Love Out Of Nothing At All (Live)	林志炫	我是歌手第一季 第9期
散了吧	林志炫	散了吧
你的眼神 (Live)	林志炫	我是歌手第一季 第8期
空	林志炫	悟空传 电影音乐原声带
御龙铭千古	林志炫	御龙在天 游戏原声带
哭砂	林志炫	一个人的样子
离歌 (Live)	林志炫	擦声而过 2
花房姑娘	林志炫	擦声而过
Writing's On The Wall (Live)	林志炫	歌手 第6期
山丘	李宗盛	山丘
给自己的歌	李宗盛	南下专线
新写的旧歌	李宗盛	新写的旧歌
鬼迷心窍	李宗盛	李宗盛 (与他们) 的凡人歌
当爱已成往事	李宗盛|林忆莲	霸王别姬
漂洋过海来看你 (Live)	李宗盛	“17聚幸福”江苏卫视2017跨年演唱会
凡人歌	李宗盛	东方之珠Ⅱ 在我生命中的每一天
我终于失去了你 (Live)	李宗盛	理性与感性 作品音乐会
领悟 (Live)	李宗盛	既然青春留不住，还是做个大叔好 演唱会巡回影音纪录
爱的代价	李宗盛	不舍
问 (Live)	李宗盛	“让幸福照亮你”江苏卫视2018跨年演唱会
我是真的爱你	李宗盛	不舍
再回首	李宗盛	滚石香港黄金十年李宗盛精选
不必在乎我是谁 (Live)	李宗盛	既然青春留不住，还是做个大叔好 演唱会巡回影音纪录
寂寞难耐	李宗盛	滚石三十青春音乐记事簿-1314
梦醒时分 (Live)	李宗盛	既然青春留不住，还是做个大叔好 演唱会巡回影音纪录
晚婚 (Live)	李宗盛	既然青春留不住，还是做个大叔好 演唱会巡回影音纪录
壮志在我胸 (Live)	李宗盛	大家乐
阴天 (Live)	李宗盛	精彩音乐汇
当爱已成往事	林忆莲|李宗盛	不必在乎我是谁
天不下雨天不刮风天上有太阳	尹相杰|于文华	中国歌典 1990's 突飞猛进的时代
纤夫的爱	于文华|尹相杰	20世纪中华歌坛名人百集珍藏版
跟你走天涯	于文华|尹相杰	20世纪中华歌坛名人百集珍藏版
甘十九妹	尹相杰	空
掀起你的盖头来	尹相杰	国宝民歌上
偷一颗月亮照亮天	于文华|尹相杰	20世纪中华歌坛名人百集珍藏版
抬花轿	尹相杰	龙凤金歌榜VOL.4
天不下雨,天不刮风,天上有太阳	于文华|尹相杰	名家名曲 5
纤夫的爱	尹相杰|于文华	一人一首成名曲（十碟装）
摇花轿	尹相杰	空
爱谁是谁	尹相杰	爱谁是谁
情哥去南方	尹相杰	打工的妹妹
欢天喜地奔小康	于文华|尹相杰	秋天的诺言
好男人	尹相杰	空
欢天喜地七仙女	尹相杰	欢天喜地七仙女
天不下雨天不刮风天上有太阳	于文华|尹相杰	20世纪中华歌坛名人百集珍藏版
纤夫的梦	于文华|尹相杰	中国绝佳经典3
上有老下有小	尹相杰	空
让我闯闯	尹相杰|于文华	演唱歌曲精选
铁道游击队	尹相杰	空
老鼠爱大米	杨臣刚	老鼠爱大米
老公PK老婆	杨臣刚	老公Pk老婆
真的爱你	杨臣刚	真的爱你
南无阿弥了陀佛	杨臣刚	真的爱你
龙	杨臣刚	龙
男人的歌	杨臣刚	我的前半声
大话西游	杨臣刚	老鼠爱大米
可不可以不想你	杨臣刚	可不可以不想你 EP
撸起袖子加油干	杨臣刚	杨臣刚新歌集
钱钱钱	杨臣刚	杨臣刚我是你老公
老鼠爱大米 (日语)	杨臣刚	空
好兄弟	杨臣刚	龙
老板难当	杨臣刚	我的前半声
我们是一家人	杨臣刚	真的爱你
老鼠爱大米 (合唱版)	杨臣刚	猪之歌
我是你老公	杨臣刚	杨臣刚我是你老公
一生只为你	杨臣刚	老公Pk老婆
活着不容易	杨臣刚	真的爱你
兔子爱萝卜	杨臣刚	空
毛主席我们想念你	杨臣刚	真的爱你
有没有	韦礼安	首张同名全创作专辑
女孩	韦礼安	硬戳
还是会	韦礼安	有人在等
慢慢等	韦礼安	慢慢等
因为爱	韦礼安	首张同名全创作专辑
别说没爱过	韦礼安	硬戳
面具	韦礼安	有所畏
第一个想到你	韦礼安	硬戳
一个人	韦礼安	硬戳
有人在等我	韦礼安	有人在等
爱如空气	韦礼安	爱如空气
风景旧曾谙	韦礼安|郭静	风景旧曾谙
似曾	韦礼安	硬戳
在你身边	韦礼安	在你身边
不需要知道	韦礼安	不需要知道
还是爱着你	韦礼安	有人在等
人质 (Live)	韦礼安	「两脚书橱的逃亡」演唱会
狼	韦礼安	有所畏
如果再见	韦礼安	硬戳
温柔 (Live)	韦礼安	盖世英雄 第9期
下个，路口，见 (Live)	李宇春	2018中国蓝燃情贺岁夜
动物世界	李宇春	动物世界
1987我不知会遇见你	李宇春	李宇春2018流行（liú xíng）巡演LIVE辑
和你一样	李宇春	N+1 Evolution
再不疯狂我们就老了	李宇春	中国音乐电视
野蛮生长	李宇春	长
蜀绣 (Live)	李宇春	李宇春野蛮生长巡演LIVE自选
流行	李宇春	流行
春风十里	李宇春	在吗？
漂洋过海来看你	李宇春	在吗？
唐人街	李宇春	唐人街
今天雨，可是我们在一起	李宇春	流行
千年游	李宇春	千年游
西门少年	李宇春	长
对不起，只是忽然很想你 (Live)	李宇春	李宇春野蛮生长巡演LIVE自选
珍惜	李宇春	陆贞传奇 电视剧原声带
口音	李宇春	流行
MAGICAL SHOW	李宇春	蛮
一趟	李宇春	流行
最浪漫的事	李宇春	在吗？
偏偏喜欢你	陈百强	偏偏喜欢你
一生何求	陈百强	一生何求
今宵多珍重	陈百强	倾诉
念亲恩	陈百强	太阳花
等	陈百强	陈百强精选
不	陈百强	偏偏喜欢你
涟漪	陈百强	突破精选
深爱着你	陈百强	深爱着你
眼泪为你流	陈百强	First Love
烟雨凄迷	陈百强	神仙也移民
一生不可自决	陈百强	Love In L.A
天才白痴梦	陈百强	亲爱的您
当我想起你	陈百强	当我想起你
今宵多珍重	陈百强	偏偏喜欢你 永远的珍藏
盼三年	陈百强	我的所有
对酒当歌	陈百强	等待您
喝彩	陈百强	几分钟的约会
相思河畔	陈百强	偏偏喜欢你
摘星	陈百强	偏偏喜欢你 永远的珍藏
冷风中	陈百强	深爱着你
走进新时代	张也	共和国的旗帜
万事如意	张也	祖国你好
人间第一情	张也	原唱经典名曲珍藏（10）
高天上流云	张也	世纪歌典13:1978-2000 Vol.4
枉凝眉	张也	生于七十年代(电视)
家和万事兴	张也	家和万事兴
小曲好唱口难开	张也	望星空
在希望的田野上	张也	望星空
九九艳阳天	张也	老情歌
泉水叮咚响	张也	望星空
月亮走,我也走	张也	望星空
沂蒙山小调	张也	望星空
敖包相会	张也|阎维文	老情歌
十送红军	张也	共和国的歌声
化蝶	张也	民歌之旅3
父亲	张也	永远的怀念
祖国你好	张也	祖国你好
咱老百姓	张也	吉祥颂
山笑水笑人欢笑 (Live)	张也	2018中央电视台春节联欢晚会
孟姜女	张也	千娇百媚-美女篇
想起老妈妈	于文华	秋天的诺言
天不下雨天不刮风天上有太阳	尹相杰|于文华	中国歌典 1990's 突飞猛进的时代
枉凝眉	于文华	于文华单曲集
纤夫的爱	于文华|尹相杰	20世纪中华歌坛名人百集珍藏版
痴情小妹妹	于文华	于文华单曲集
跟你走天涯	于文华|尹相杰	20世纪中华歌坛名人百集珍藏版
丈夫辛苦了	于文华	不要惦记家
沂蒙山小调 (Live)	于文华	2012央视元宵晚会
贵妃醉酒	于文华	于文华单曲集
今天我做你的新娘	于文华	于文华单曲集
中华全家福	于文华	于文华单曲集
花为媒·夸月娥	于文华	百姓的事比天大
老毕的爱	于文华	于文华单曲集
你的生命如此美丽	于文华	亲吻你再久依然恋着你
想起老妈妈	于文华	文革歌曲合集之6－经典老歌
绣鸳鸯	于文华	20世纪中华歌坛名人百集珍藏版
天不下雨天不刮风天上有太阳	于文华|尹相杰	20世纪中华歌坛名人百集珍藏版
偷一颗月亮照亮天	于文华|尹相杰	20世纪中华歌坛名人百集珍藏版
沿着社会主义大道奔前方	于文华	于文华单曲集
沂蒙山小调	于文华	于文华单曲集
爱与诚	古巨基	大雄
情歌王	古巨基	劲歌金曲2：情歌王
爱得太迟	古巨基	Human 我生
劲歌金曲	古巨基	劲歌·金曲
好想好想	古巨基	恋恋情深
必杀技	古巨基	劲歌金曲2：情歌王
恋无可恋	古巨基	喜爱夜蒲2 电影原声带
匆匆那年 (Live)	古巨基	我是歌手第三季 第6期
情人 (Live)	古巨基	英皇15周年群星演唱会
重复犯错	古巨基	Human 我生
找到你是我最伟大的成功	古巨基	找到你是我最伟大的成功
突然好想你 (Live)	古巨基	我是歌手第三季 第4期
爆了	古巨基	Amazing World
眼睛不能没眼泪	古巨基	Guitar Fever
何必打扰	古巨基	我们
爱得太迟	古巨基	Human 我生
忘了时间的钟	古巨基	忘了时间的钟
父亲 (Live)	古巨基	我是歌手第三季 第2期
劲歌金曲3 Party King	古巨基	Amazing World
友共情	古巨基	欢乐今宵
朋友	臧天朔	歌声飘扬60年——向新中国成立六十周年献礼（第十九集）
爱到永远	臧天朔	悲情咖啡屋4
山歌好比春江水	臧天朔	山歌好比春江水
心的祈祷		点赞
分别的时候	臧天朔	冲入禁区
夜色	臧天朔|郑钧	空
我祈祷	孙楠	写不完的爱
路边的野花不要采	臧天朔	告别的摇滚
梦碟		声色江南I—烟雨倾城
朋友		十亿皇帝
一路走来	臧天朔	空
哥哥把你栓在心头	杭天琪|臧天朔	空
我祈祷	臧天朔	 
心经 (合唱版)	臧天朔	心经
面向大海		巴洛克-被忘却的精神国
梦蝶 (Live)	臧天朔	 
都在等着你	臧天朔	中国歌曲排行榜 1999年度十大金曲
等待那一天 (Live)	臧天朔	 
老玉米 (DJ版)	臧天朔	 
朋友 (DJ版)	臧天朔	 
我终于失去了你	赵传	我终于失去了你
爱要怎么说出口	赵传	作品李宗盛
我是一只小小鸟	赵传	驿动男人心1
我很丑，可是我很温柔 (温柔版)	赵传	我很丑，可是我很温柔
给所有知道我名字的人	赵传	10年朋友 10
勇敢一点	赵传	勇敢一点
把悲伤留给自己	赵传	我终于失去了你
你如何还能这样温柔	赵传	我终于失去了你
我的心好乱	赵传	爱情麻辣烫 电影情歌精选
一颗滚石	赵传	一颗滚石的25年
沉默的羔羊	赵传	约定
每次都想呼喊你的名字 (Live)	赵传	我是歌手第四季 第6期: 踢馆赛
那个傻瓜爱过你	赵传	那个傻瓜爱过你
大地	赵传	爱我就给我
请不要在别人的肩上哭泣	赵传	我很丑，可是我很温柔
我很丑，可是我很温柔 (Live)	赵传	梦想星搭档第二季 第10期
曾经的你 (Live)	赵传	我是歌手第四季 第12期: 突围赛
噢！莎莉	赵传	精挑细选 精选辑
我一直以为你知道	赵传	我很丑，可是我很温柔
爱要怎么说出口 (Live)	赵传	梦想星搭档第二季 第6期
喜欢你现在的样子 (Live)	黄韵玲	中国新歌声第二季 第11期
喜欢你现在的样子	黄韵玲	做我的朋友
听！是谁在唱歌	刘若英|黄韵玲	闭上眼睛去旅行3-感伤，于是旅行
心动	黄韵玲	四手连弹之打翻音乐盒
三个人的晚餐	黄韵玲	我想要一个小孩十年精选
听一首伤心的歌	黄韵玲	巴结音乐
生命中的精灵 (Live)	黄韵玲	中国新歌声第二季 第10期
春暖花开 (Unplugged)	黄韵玲	春暖花开
You Are The Sunshine Of My Life	方大同|黄韵玲	Timeless 可啦思刻
简单的事情	黄韵玲	美好岁月
女朋友男朋友	黄韵玲	永恒· 承诺
你是唯一	黄韵玲	黄韵玲精选辑(一) 忧伤男孩
至少还有你	黄韵玲	四手连弹之打翻音乐盒
关不掉的收音机	黄韵玲	女生向前走
天黑黑 (Live)	古巨基|黄韵玲	梦想星搭档 第6期
改变	黄韵玲	黄韵玲精选辑(一) 忧伤男孩
我在这里等你	黄韵玲	蓝色啤酒海/你就是你
青鸟	黄韵玲	初熟之物
蝶恋	黄韵玲	在我们之间的事
听 是谁在唱歌	刘若英|黄韵玲	Rene
你的承诺	海鸣威	Dance Dance Dance
老人与海	海鸣威	Dance Dance Dance
我的回忆不是我的	海鸣威	Dance Dance Dance
一个人的北京	海鸣威	一个人的北京
工体爱情故事	海鸣威	工体爱情故事 2012新歌+精选
分开以后	海鸣威	分开以后
人海	海鸣威	人海
爱没有谁对不起谁	海鸣威	我的回忆不是我的
老人与海	海鸣威	梦醉心声 汽车音响专用
你的承诺	海鸣威	私人珍藏
离开为了更好的回来	海鸣威	离开为了更好的回来
身不由己	海鸣威	Dance Dance Dance
我的回忆不是我的	海鸣威	伤感情歌对唱
伤心的海	海鸣威	Dance Dance Dance
你的承诺	海鸣威	我的回忆不是我的
落叶	海鸣威	落叶
舞动全城	海鸣威	Dance Dance Dance
在月光下歌唱	海鸣威	在月光下歌唱
我的回忆不是我的	海鸣威	多一点
彩虹背后	海鸣威	Dance Dance Dance
浪子心声	许冠杰	半斤八两
半斤八两	许冠杰	半斤八两
沉默是金	张国荣|许冠杰	劲歌金曲
沧海一声笑	许冠杰	香港情怀'90
天才与白痴	许冠杰	天才与白痴
打雀英雄传	许冠杰	半斤八两
梨涡浅笑	许冠杰	半斤八两
有酒今朝醉	许冠杰	十年代表作
阿郎恋曲	许冠杰	许冠杰89歌集
天才白痴梦	许冠杰	许冠杰精选
双星情歌	许冠杰	环球DSD视听之王 - 许冠杰
十个女仔	许冠杰	79夏日之歌集
最佳拍档	许冠杰	难忘你、纸船
日本娃娃	许冠杰	最紧要好玩
知音梦里寻	许冠杰	半斤八两
无情夜冷风	许冠杰	鬼马双星
何日再相逢	许冠杰	79夏日之歌集
父母恩	许冠杰	卖身契
学生哥	许冠杰	卖身契
急流勇退	许冠杰	环球影音启示录 - 许冠杰
给所有知道我名字的人 (Live)	罗琦	我是歌手第二季 第6期
我期待 (Live)	罗琦	我是歌手第二季 第2期
随心所欲	罗琦	把你唱醉
Knocking on Heaven's Door (Live)	罗琦	我是歌手第二季 第3期
我是一只小小鸟 (Live)	罗琦	我是歌手第二季 第5期
回来	罗琦	把你唱醉
我没有远方	罗琦	把你唱醉
我相信 (Live)	罗琦	我是歌手第二季 第4期
随心所欲 (Live)	罗琦	我是歌手第二季 第1期
把你唱醉	罗琦	把你唱醉
重生	罗琦	重生
敲响天堂之门 (Live)	罗琦	罗琦“树生长的声音”2015巡演南京站
我	罗琦	快乐机器
给所有知道我名字的人 (2014我是歌手第二季第六期现场伴奏)	罗琦	 
雨夜里的烦恼	罗琦	把你唱醉
回来 (2013为中国歌唱现场)	罗琦	 
给所有知道我名字的人 (铃声)	罗琦	
不想再是小孩	罗琦	把你唱醉
让我自己来	罗琦	让我自己来
幸亏我还年轻	罗琦	快乐机器
背叛	曹格	SUPERMAN
寂寞先生	曹格	超级4th场
梁山伯与茱丽叶	曹格	十年曹格「小小」特别企划数字精选
掌纹	曹格	超级4th场
数到五答应我	曹格	Naughty Gentleman
无辜	曹格	Super Sunshine
世界唯一的你	曹格	格格Blue
Superwoman	曹格	格格Blue
我很丑可是我很温柔 (Live)	曹格	我是歌手第二季 第2期
两只恋人	曹格	SUPERMAN
海阔天空 (Live)	曹格	我是歌手第二季 突围赛
梁山伯与茱丽叶	曹格	习惯
爷爷	曹格	曹之在我
入戏	曹格	超级4th场
丑角	曹格	曹之在我
明天会更好 + We Are The World (Live)	曹格	我是歌手 2015巅峰会
吹吹风	曹格	Super Sunshine
你是我的宝贝	曹格	SUPERMAN
借我一辈子	曹格	超级4th场
悲歌王	曹格	曹之在我
亲爱的你怎么不在我身边	江美琪	想起
那年的情书	江美琪	巧克力-Chocolato (靡音阁音乐采编系列之六)
想起	江美琪	想起
路人	江美琪	爱哭鬼
东京铁塔的幸福 (Live)	江美琪	金曲捞 第3期
我又想起你	江美琪	悄悄话
爱哭鬼	江美琪	爱哭鬼
他一定很爱你	江美琪	美乐地 Melody
对你有感觉	江美琪	爱哭鬼
朋友的朋友	江美琪	朋友的朋友
我心似海洋	江美琪	恋人心中有一首诗
东京铁塔的幸福	江美琪	再一次也好
夜的诗人	江美琪	再一次也好
双手的温柔	江美琪	悄悄话
星晴	江美琪	美乐地 Melody
袖手旁观	江美琪	第二眼美女
亲爱的你怎么不在身边	江美琪	白羽毛之恋 华语典藏情歌 Vol.2
凝望	江美琪	想起
最美	江美琪	美乐地 Melody
拥抱	江美琪	美乐地 Melody
执着	田震	真的田震
风雨彩虹铿锵玫瑰 (Live)	田震	精彩音乐汇
风雨彩虹 铿锵玫瑰	田震	歌声飘扬60年——向新中国成立六十周年献礼（第三十集）
好大一棵树	田震	真的田震
跟着感觉走	田震	空
靠近我	田震	震撼
月牙泉	田震	阿里山的姑娘
黄土高坡	田震	歌声飘扬60年——向新中国成立六十周年献礼（第九集）
爱不后悔	田震	震撼
水姻缘	田震	阿里山的姑娘
怕黑的女人	田震	贪声好色全精选
阿里山的姑娘	田震	水姻缘
谁为我停留	田震	干杯，田震 (1995-2001 作品全集)
玩儿个痛快 + 干杯朋友 + 靠近我 + 执着 + 爱不后悔 + 铿锵玫瑰 (Live)	田震	我为歌狂 总决赛
我热恋的故乡	田震	20世纪中华歌坛名人百集珍藏版
未了情	田震	阿里山的姑娘
又见炊烟	田震	无名的小花
北国之春	田震	美丽的海湾
让我再看你一眼	田震	流行天地 中录10年金曲2
等待	田震	玩的就是心跳
预谋	许佳慧	一拍两散
宽容	许佳慧	宽容
一拍两散	许佳慧	一拍两散
别把借口当理由	许佳慧	平行线
本末倒置	许佳慧	本末倒置
我在神经什么	许佳慧	我在神经什么
说好一起走	许佳慧	说好一起走
平行线	许佳慧	平行线
你想好怎么对她说	许佳慧	你想好怎么对她说
真的爱上你	许佳慧	一拍两散
情歌唱给自己听	许佳慧	独家情话
转身离开	许佳慧	平行线
我别这样好不好	许佳慧	我别这样好不好
诡爱	许佳慧	独家情话
回到那时候	许佳慧	平行线
在一块	许佳慧	独家情话
左手爱了右手痛	许佳慧	左手爱了右手痛
这又何必	许佳慧	这又何必
吻过爱过的你	许佳慧	回到那时候
没有勇气	许佳慧	没有勇气
慢慢	张学友	忘记你我做不到
如果这都不算爱	张学友	学友 热
只想一生跟你走	张学友	我与你
遥远的她 (粤语)	张学友	遥远的她•Amour
一路上有你	张学友	吻别
一千个伤心的理由	张学友	真爱
吻别	张学友	吻别
她来听我的演唱会	张学友	走过1999
等你等到我心痛	张学友	我与你
忘记你我做不到	张学友	忘记你我做不到
饿狼传说	张学友	爱得比你深
心如刀割	张学友	走过1999
回头太难	张学友	祝福
想和你去吹吹风	张学友	想和你去吹吹风
旧情绵绵	张学友	我与你
情书	张学友	忘记你我做不到
你最珍贵	张学友	不后悔
相思风雨中	张学友	真情流露
我真的受伤了	张学友	学友 热
夕阳醉了	张学友	只愿一生爱一人
我以为	品冠	爱到无可救药
那些女孩教我的事	品冠	那些女孩教我的事
明明很爱你	品冠|梁静茹	门没锁
掌心 (Live)	品冠	我是歌手第二季 第5期
我不愿让你一个人 (Live)	品冠	我是歌手第二季 第7期
疼你的责任	品冠	疼你的责任
无可救药	品冠	爱到无可救药
陪你一起老	品冠	疼你的责任
后来的我们	品冠	后来的我
哄我入睡	品冠	爱到无可救药
门没锁	品冠	门没锁
又一年又三年	品冠	后来的我
我一个人记得就好	品冠	失去你的那一天 电视剧原声带
为你我想做更好的人	品冠	未拆的礼物
随时都在	品冠	随时都在
未拆的礼物	品冠	未拆的礼物
我不难过 (Live)	品冠	我是歌手第二季 第6期
半生熟	品冠|戴佩妮	那些女孩教我的事
还好有你	品冠	还好有你
无关善良	品冠	步步惊情 电视剧原声带
醉赤壁	林俊杰	JJ陆
那些你很冒险的梦	林俊杰	学不会
可惜没如果	林俊杰	新地球
不为谁而作的歌	林俊杰	不为谁而作的歌
修炼爱情	林俊杰	因你而在
她说	林俊杰	她说 概念自选辑
江南	林俊杰	第二天堂
Always Online	林俊杰	JJ陆
当你	林俊杰	她说 概念自选辑
背对背拥抱	林俊杰	100天
爱要怎么说出口 (Live)	林俊杰	梦想的声音 第10期
爱笑的眼睛	林俊杰	她说 概念自选辑
一千年以后	林俊杰	编号89757
我还想她	林俊杰	JJ陆
小酒窝 (国语)	林俊杰	JJ陆
曹操	林俊杰	曹操
关键词	林俊杰	和自己对话 From M.E. To Myself
输了你赢了世界又如何 (Live)	林俊杰	梦想的声音第二季 第4期
美人鱼	林俊杰	第二天堂
学不会	林俊杰	学不会
囚鸟	彭羚	囚鸟
让我跟你走	彭羚	EMI至爱经典系列 - 彭羚
如梦初醒	彭羚	如梦初醒
你未讲过	彭羚	我的...
我有我天地	彭羚	EMI至爱经典系列 - 彭羚
缠绵游戏	彭羚	给我唱过的男孩们
完全因你	彭羚	和平饭店
小玩意	彭羚	EMI至爱经典系列 - 彭羚
让我取暖	彭羚|王力宏	好好爱
仍然是最爱你	彭羚	EMI至爱经典系列 - 彭羚
彷如隔世	彭羚	完全因你
烂泥	彭羚	给我唱过的男孩们
夜风铃	彭羚	EMI至爱经典系列 - 彭羚
心淡 (Live)	容祖儿|彭羚	Concert YY 黄伟文作品展 演唱会
爱过痛过亦愿等	彭羚	EMI至爱经典系列 - 彭羚
让我跟你走	彭羚|巫启贤	未完的小说
爱我别走	彭羚	给我唱过的男孩们
情书	彭羚	给我唱过的男孩们
重回那天那地	彭羚	一千零一晚
K歌之王	彭羚	给我爱过的男孩们. 10週年24K金碟限量版
挥着翅膀的女孩	容祖儿	一百个我 国语新曲+精选
独照	容祖儿	独照
小小	容祖儿	小小
习惯失恋	容祖儿	我的骄傲
心淡	容祖儿	我的骄傲
怯	容祖儿	隆重登场
16号爱人	容祖儿	Give Love A Break
心之科学	容祖儿	心之科学
痛爱	容祖儿	喜欢祖儿
月半小夜曲 (Live)	容祖儿	我是歌手第四季 第7期: 补位赛
连续剧	容祖儿	On Call 36小时 电视剧原声带
一拍两散	容祖儿	Nin9 2 5Ive
花千树	容祖儿	Joey & Joey
破相	容祖儿	空港
烟霞	容祖儿	Give Love A Break
想着你的感觉 (Live)	容祖儿	我是歌手第四季 第8期: 淘汰赛
续集	容祖儿	续集
共你痴痴爱在	容祖儿	共你痴痴爱在
天窗	容祖儿	天窗
爱情复兴	容祖儿	Jump Up 9492
私奔	郑钧	长安长安
灰姑娘 (Live)	郑钧	乐人·Live：郑钧“私奔”全国巡演北京站（Live）
回到拉萨	郑钧	歌声飘扬60年——向新中国成立六十周年献礼（第二十一集）
流星	郑钧	郑钧=zj
赤裸裸 (Live)	郑钧	湘江音乐节
长安长安	郑钧	长安长安
要死就一定要死在你手里 (Live)	郑钧	走进心时代
热爱	郑钧	热爱
天下没有不散的筵席	郑钧	第三只眼
风马	郑钧	风马
极乐世界 (Live)	郑钧	乐人·Live：郑钧“私奔”全国巡演北京站（Live）
花儿为什么这样红	郑钧	我心飞翔 电影原声带
爱的箴言	郑钧	我们的生活 充满阳光
路漫漫 (Live)	郑钧	乐人·Live：郑钧“私奔”全国巡演北京站（Live）
喀秋莎 + 莫斯科郊外的晚上 (Live)	郑钧	温暖呐喊 2005北京工体演唱会
老男孩	郑钧	长安长安
长安长安 (Live)	郑钧	金曲捞 第3期
夜色	臧天朔|郑钧	空
商品社会 (Live)	郑钧	乐人·Live：郑钧“私奔”全国巡演北京站（Live）
我是你免费的快乐	郑钧	风马
冬季到台北来看雨	孟庭苇	冬季到台北来看雨
风中有朵雨做的云	孟庭苇	风中有朵雨做的云
羞答答的玫瑰静悄悄地开	孟庭苇	红花
谁的眼泪在飞	孟庭苇	谁的眼泪在飞
你看你看月亮的脸	孟庭苇	你看你看月亮的脸
你究竟有几个好妹妹	孟庭苇	1990-1994 钻石金选集
无声的雨	孟庭苇	冬季到台北来看雨
没有情人的情人节	孟庭苇	冬季到台北来看雨
一个爱上浪漫的人	孟庭苇	你看你看月亮的脸
往事	孟庭苇	钻石金选集
伤了你的心的我的心	孟庭苇	孟庭苇的音乐盒
红雨	孟庭苇	你看你看月亮的脸
野百合也有春天	孟庭苇	钻石金选集
三生三世	孟庭苇	谁的眼泪在飞
雾里看花	孟庭苇	孟庭苇·改变 典藏特辑
你那里下雪了吗	孟庭苇	空
真的还是假的	孟庭苇	纯真情歌
春花秋月何时了 (Live)	孟庭苇	经典咏流传 第9期
我只在乎你 (Live)	孟庭苇	围炉音乐会 第24期
化身为海	孟庭苇	谁的眼泪在飞
Don't Break My Heart	窦唯	希望之光精选辑
高级动物	窦唯	黑梦
噢！乖	窦唯	黑梦
艳阳天	窦唯	艳阳天
怕你为自己流泪	窦唯	希望之光精选辑
黑色梦中	窦唯	黑梦
悲伤的梦	窦唯	黑梦
窗外	窦唯	艳阳天
上帝保佑	窦唯	黑梦
雨吁	窦唯	雨吁
明天更漫长	窦唯	黑梦
迷走江湖	窦唯	迷走江湖
暮春秋色	窦唯	幻听
山河水	窦唯	山河水
希望之光	窦唯	希望之光精选辑
重返魔域	窦唯	重返魔域
开心电话	窦唯	黑梦
送别2017	窦唯	送别2017
Take Care	窦唯	梦 十年精选
黄昏	窦唯	艳阳天
直到时间尽头	赵静怡	直到时间尽头
蜕变	赵静怡	蜕变
小叮当	赵静怡	繁星儿童艺术团
直到时间尽头 (铃声)	赵静怡	
点燃未来	赵静怡	5sing原创音乐精选
我的左手旁边是你的右手	赵静怡	超级女声 终极PK
傻笑	周杰伦|袁咏琳	十二新作
画沙	周杰伦|袁咏琳	网络情歌最伤感
怎么了	周杰伦|袁咏琳	哎呦，不错哦
刺猬的拥抱	袁咏琳	Fight For Love
很旅行的爱情	袁咏琳	袁咏琳 Cindy
黑色幽默 (Live)	周杰伦|袁咏琳	The Era 2010 超时代演唱会
心底	袁咏琳	幻城 电视剧原声带
陷阱	袁咏琳	陷阱
只好倔强	袁咏琳	此刻正好
That's Alright	袁咏琳	此刻正好
你想娶我吗	袁咏琳	此刻正好
爱是黑白	袁咏琳	Fight For Love
安排	袁咏琳	第一次 电影原声带
热气球	袁咏琳	袁咏琳 Cindy
Fighting For Love	袁咏琳	Fighting For Love
把伤心打碎	袁咏琳	陷阱
雨后天空	袁咏琳	袁咏琳 Cindy
尘埃	袁咏琳	乐酷‧概念合辑
你不爱我了	袁咏琳	袁咏琳 Cindy
画沙	袁咏琳	袁咏琳 Cindy
不求	杨培安	不求
我相信 (Live)	杨培安	精彩音乐汇
黄河长江 (Live)	杨培安	经典咏流传 第5期
忘记你不如失去你	杨培安	抒情
痛也不说出口的我	杨培安	杨培安II
生死相随	杨培安	秦时丽人明月心 电视剧原声带
这该死的爱	杨培安	超级星光PK宝典2
左边右边	杨培安	抒情
光辉岁月	杨培安	风飞沙
完美世界	杨培安	杨培安II
梦想从心开始	杨培安	希望的种子
梦想的翅膀	杨培安	梦想的翅膀
信仰	杨培安	沉睡的野兽
生死相随	杨培安	秦时丽人明月心 电视剧原声带
谢谢让我爱上你	杨培安	杨培安II
彩虹的尽头	杨培安	希望的种子
让全世界为我们加油	杨培安	杨培安II
最短的爱情	杨培安	沉睡的野兽
梦在前方	杨培安	梦在前方
有你有明天	杨培安	抒情
恋爱症候群	黄舒骏	未央歌
马不停蹄的忧伤	黄舒骏	未央歌
未央歌	黄舒骏	24K黃金CD
何德何能	黄舒骏	未央歌
雁渡寒潭	黄舒骏	雁渡寒潭
她以为她很美丽	黄舒骏	未央歌
这就是爱	黄舒骏	何德何能
男女之间	黄舒骏	我是谁
不要只因为他亲吻了你	黄舒骏	未央歌
思念进行曲	黄舒骏	山盟海誓
我是谁	黄舒骏	我是谁
少年狂想曲	黄舒骏	未来的街头
是否真心如我	黄舒骏	山盟海誓
谈恋爱	黄舒骏	山盟海誓
未来的街头	黄舒骏	未来的街头
窗	黄舒骏	未央歌
为你疯狂	黄舒骏	为你疯狂
爱如此徘徊	黄舒骏	崩溃
天平座的女子	黄舒骏	马不停蹄的忧伤
听不懂的话	黄舒骏	24K黃金CD
我眼泪都笑了	刘力扬	空
一夜荡漾	刘力扬	一夜荡漾
给我个理由	刘力扬	越囧
我在人民广场吃炸鸡 (chicken style)	刘力扬	我在人民广场吃炸鸡（chicken style）
Rain.希莱梅	刘力扬	超级女声 美梦成真
Set You Free	刘力扬	Set You Free
属于你的歌	刘力扬	空
不朽	刘力扬	库仑定律
Work For Light	刘力扬	Work For Light
礼物 (铃声)	刘力扬	
我就是这样(Mcyy)Remix	刘力扬	 
眼泪笑了 (MV版)	刘力扬	 
暂时不要多话	刘力扬	暂时不要多话
礼物 (升调版伴奏)	刘力扬	 
若即若离	刘力扬	星洲之夜 电视原声带
我就是这样 (KTV版伴奏)		 
一句一伤 (铃声)	刘力扬	
TiAmo (铃声)	刘力扬	
眼泪笑了 (铃声)	刘力扬	
礼物 (伴奏)	刘力扬	 
刀马旦	李玟|周杰伦	Promise
想你的365天	李玟	碰碰看爱情
Di Da Di	李玟	Di Da Di 暗示
叩叩	李玟	盛开
月光爱人 (A Love Before Time (Mandarin)(Voice))	李玟	Crouching Tiger, Hidden Dragon
好心情	李玟	Sunny Day 好心情
Baby对不起	李玟	Promise
你是我的Superman	李玟	Sunny Day 好心情
美丽笨女人	李玟	Di Da Di 暗示
真情人	李玟	真情人You & Me
So Crazy	李玟	Promise
颜色	李玟	Sunny Day 好心情
月光爱人	李玟	Promise
自己	李玟	Sunny Day 好心情
真想见到你	李玟	Di Da Di 暗示
过完冬季	李玟	Di Da Di 暗示
不潮不用花钱 (Live)	李玟	我是歌手第四季 第10期: 补位赛
魔镜	李玟	今天到永远
Before I Fall In Love	李玟	Just No Other Way
爱你爱到	李玟	真情人You & Me
证据	杨乃文	应该
星星堆满天	杨乃文	ONE
祝我幸福	杨乃文	应该
我给的爱	杨乃文	Silence
静止	杨乃文	Silence
未接来电 (Live)	杨乃文	湘江音乐节
忽然之间 (Live)	杨乃文	蒙面唱将猜猜猜 第9期
花房姑娘 (Live)	杨乃文	蒙面唱将猜猜猜 第10期
一个人	杨乃文	ONE
静止 (Live)	杨乃文	蒙面唱将猜猜猜 第11期
我要我们在一起 (Live)	杨乃文	蒙面唱将猜猜猜 第10期
野百合也有春天 (Live)	彭佳慧|杨乃文	蒙面唱将猜猜猜 第9期
应该	杨乃文	应该
逃兵	杨乃文	逃兵
女爵 (Live)	杨乃文	湘江音乐节
最初的地方 (Live)	杨乃文	冬之火 九重天演唱会特选录音专辑
可惜爱	杨乃文	回到爱开始的地方 电影原声带
爱上你只是我的错	杨乃文	第一张精选
漂着	杨乃文	应该
不要告别	杨乃文	Silence
Jar Of Love	曲婉婷	我的歌声里
没有什么不同	曲婉婷	我的歌声里
我的歌声里	曲婉婷	我的歌声里
爱的勇气	曲婉婷	爱的勇气
Drenched	曲婉婷	春娇与志明 电影原声大碟
Everything In The World	曲婉婷	Everything In The World (白金庆功版)
快活	曲婉婷	我的歌声里
承认	曲婉婷	我的歌声里
爱的海洋 (Special Holiday Version)	曲婉婷	Say The Words
我为你歌唱 (中文版)	曲婉婷	Say The Words
最好的安排	曲婉婷	最好的安排
阳光下的我们	曲婉婷	阳光下的我们
Love Struck Me Down	曲婉婷	Say The Words
我只在乎你	曲婉婷	空
Sing For You	曲婉婷	Say The Words
今天	曲婉婷	我的歌声里
老男孩	曲婉婷	空
Life Is Like A Song	曲婉婷	我的歌声里
Your Girl	曲婉婷	Your Girl
My Little Friend	曲婉婷	Say The Words
其实都没有	杨宗纬	初.爱 (影音典藏版)
这一路走来	杨宗纬	初.爱 (影音典藏版)
空白格	杨宗纬	空白格
一次就好	杨宗纬	夏洛特烦恼 电影原声带
洋葱	杨宗纬	鸽子
我变了 我没变	杨宗纬	我变了 我没变
越过山丘	杨宗纬	越过山丘
那个男人	杨宗纬	原色
凉凉	杨宗纬	三生三世十里桃花 电视剧原声带
我们好像在哪见过	杨宗纬	咱们结婚吧 电视剧原声带
初爱	杨宗纬	初.爱 (影音典藏版)
一场恋爱	杨宗纬	猎场 电视剧原声带
忘了我	杨宗纬	初.爱 (影音典藏版)
流浪记 (Live)	杨宗纬	我是歌手第一季 第11期
给未来的自己 (Live)	杨宗纬	Star! Start! 星空传奇演唱会
校园民谣创意混编 (Live)	杨宗纬	快乐中国毕业歌会
听说爱情回来过 (Live)	杨宗纬	Star! Start! 星空传奇演唱会
为了遇见你	杨宗纬	L to V 秘密
为你我受冷风吹	杨宗纬	空
最爱 (Live)	杨宗纬	我是歌手第一季 第12期
我是你的谁	黄立行	忙与盲 (大陆版)
音浪	黄立行	音浪
分开旅行	刘若英|黄立行	K歌情人派对
无神论	黄立行	无神论
黑夜尽头	黄立行	最后只好躺下来
乖乖牌	蔡依林|黄立行	舞娘
又不是真的爱	黄立行	Stan Up
Go	黄立行	空
礼物	黄立行	无神论
最后只好躺下来	黄立行	最后只好躺下来
无神论 (英语)	黄立行	无神论
巴别塔	黄立行	最后只好躺下来
你装酷,我想吐	黄立行	马戏团猴子
传奇	黄立行	音浪
Let It Go	萧亚轩|黄立行	明天
冷水澡	黄立行	你身边
预言	黄立行	音浪
你身边	黄立行	你身边
静静的生活	黄立行|陈绮贞	蓝调 The Blues
Machi	黄立行	音浪
遇见	孙燕姿	The Moment
我怀念的	孙燕姿	逆光
开始懂了	孙燕姿	我要的幸福
逆光	孙燕姿	逆光
绿光	孙燕姿	风筝
天黑黑	孙燕姿	孙燕姿 同名专辑
我也很想他	孙燕姿	Stefanie
我不难过	孙燕姿	未完成
Hey Jude	孙燕姿	Start 自选集
原来你什么都不要	孙燕姿	Start 自选集
眼泪成诗	孙燕姿	完美的一天
雨天	孙燕姿	My Story，Your Song 经典全记录
在，也不见	孙燕姿	在，也不见
克卜勒	孙燕姿	克卜勒
第一天	孙燕姿	完美的一天
Honey Honey	孙燕姿	完美的一天
半句再见	孙燕姿	半句再见
尚好的青春	孙燕姿	克卜勒
直来直往	孙燕姿	离开
当冬夜渐暖	孙燕姿	是时候
月半小夜曲	李克勤	命运符号
红日 (粤语)	李克勤	红日
护花使者	李克勤	宝丽金88极品音色系列 - 李克勤
一生不变	李克勤	Purple Dream
友情岁月	李克勤	复克II
一生中最爱 (Live)	谭咏麟|李克勤	左麟右李2003香港演唱会
富士山下 (Live)	李克勤	Joey Yung & Hacken Lee Concert 2015
和你在一起	李克勤	和你在一起
遥远的她	李克勤	复克II
天梯 (Live)	李克勤	我是歌手第四季 第10期: 补位赛
合久必婚 (Live)	容祖儿|李克勤	Joey Yung & Hacken Lee Concert 2015
没有你赢了世界又如何	李克勤	环球一双情缘系列 - 李克勤
一生何求	李克勤	一生何求
深深深	李克勤	宝丽金88极品音色系列 - 李克勤
终身美丽 (Live)	李克勤	情情塔塔演唱会
相爱很难 (Live)	容祖儿|李克勤	Joey Yung & Hacken Lee Concert 2015
大会堂演奏厅	李克勤	宝丽金88极品音色系列 - 李克勤
男人的歌	谭咏麟|李克勤	精选到无朋友
我不会唱歌 (粤语)	李克勤	从头认识
单身狗	李克勤	单身狗
心动	陈洁仪	重译
心如刀割 (Live)	陈洁仪	我是歌手第三季 第2期
喜欢你	陈洁仪	伤心
遗憾	陈洁仪	重译
从前的我	陈洁仪	从前的我
红色高跟鞋 (Live)	陈洁仪	蒙面唱将猜猜猜第二季 第7期
左右手 (NEW RECORDING)	陈洁仪	重译 陈洁仪·重奏
爱不爱我 (Live)	陈洁仪	蒙面唱将猜猜猜第二季 第8期
至少还有你 (Live)	陈洁仪	蒙面唱将猜猜猜第二季 第8期
每一生都等你	陈洁仪	封神榜 电视剧原声带
你把我灌醉	陈洁仪	重译
入戏太深	陈洁仪	入戏太深
心会跟爱一起走	陈洁仪	不要伤了和气
Nothing Compares 2 U (Live)	陈洁仪	我是歌手第三季 第3期
他不适合你	陈洁仪	萝拉
醇酒醉影	张学友|陈洁仪	Greatest Hits 新歌+精选
等了又等	陈洁仪	入戏太深
被风吹散的人们 (Live)	陈洁仪	超强音浪 第7期
越吻越伤心	陈洁仪|苏永康	私房歌
祝君好 (粤语)	陈洁仪	等。
逆光飞翔	范逸臣	爱闪亮 电视剧原声带
最近的距离，最远的旅行	范逸臣	最近的距离，最远的旅行
黑白之间	范逸臣	如果爱忘了
国境之南 (Live)	范逸臣	空
放生 (yy版)	范逸臣	 
放生 (原版伴奏)	范逸臣	
放生 (DL版)	范逸臣	 
不能没有你	范逸臣	在我心里有个你
无乐不作好时光	范逸臣	无乐不作好时光
流浪	范逸臣	暴走吧，女人 电影原声带
秀丽江山	范逸臣	空
国境之南		国境之南
我是谁	范逸臣	摇滚吧，情歌！
I Believe (KTV版伴奏)	范逸臣	 
放生 (升调版伴奏)	范逸臣	 
无缘	范逸臣	空
无乐不作 (Live)		中国新声代第三季 第3期
花房姑娘 + 假行僧 + 快让我在这雪地上撒点野 (Live)	范逸臣|谭维维	2015湖南卫视跨年演唱会
放生 (DJ现在版)	范逸臣	 
我的爱	范逸臣|许慧欣	K歌情人梦 电视剧原声带
Beautiful Love	蔡健雅	T-time 新歌+精选
红色高跟鞋 (Live)	蔡健雅	《失语者》北京首唱会
被驯服的象 (Live)	蔡健雅	《失语者》北京首唱会
重来	蔡健雅	Cherished 割爱
别找我麻烦 (Live)	蔡健雅	隐藏的歌手 第8期
陌生人	蔡健雅	陌生人
无底洞	蔡健雅	陌生人
当我想你的时候 (Live)	蔡健雅	中国新歌声 第6期
思念是一种病	张震岳|蔡健雅	OK
紫	蔡健雅	悟空传 电影音乐原声带
停格 (Live)	蔡健雅	《失语者》北京首唱会
下一次爱情来的时候	蔡健雅	双栖动物
空白格 (前半 Live)	蔡健雅	隐藏的歌手 王中王争霸战
True Love	蔡健雅	记念
原点	蔡健雅|孙燕姿	双栖动物
Beautiful  Love	蔡健雅	城市 女声
二手烟	蔡健雅	双栖动物
失语者 (Live)	蔡健雅	隐藏的歌手 第8期
双栖动物	蔡健雅	双栖动物
路口	蔡健雅	T-time 新歌+精选
月满西楼	龚玥	金装小月
父亲	龚玥	民歌红1
女儿情	龚玥	民歌红2
大悲咒	龚玥	天女之声
梦里水乡	龚玥	民歌红 3
枕着你的名字入眠	龚玥	80恋歌
枉凝眉	龚玥	四大名著
牧羊曲	龚玥	民歌红1
遇上你是我的缘	龚玥	民歌红1
十送红军	龚玥	民歌红1
化蝶	龚玥	民歌红 3
烟花三月	龚玥	金装小月
母亲	龚玥	民歌红1
为了谁	龚玥	民歌红1
走西口	龚玥	民歌红 3
晚秋	龚玥	80恋歌
月光下的凤尾竹	龚玥	民歌红1
驼铃	龚玥	军歌红
红豆红	龚玥	民歌红 3
走天涯	龚玥	我要去西藏
梦醒了	袁惟仁	你不知道的我
坦白	袁惟仁	你不知道的我
想念	袁惟仁	你不知道的我
旋木	袁惟仁	你不知道的我
勇敢一点	袁惟仁	你不知道的我
梦一场	那英	干脆
你不知道的我	袁惟仁	你不知道的我
执迷不悔	彭佳慧	醉佳时分
梦一场 (Live)	袁惟仁	中国乐队 第11期
香港爱情故事	袁惟仁|陈楚生	木吉他
木吉他	袁惟仁	木吉他
东区那条巷子	袁惟仁	木吉他
你的温度	蔡健雅	记念
梦一场		遥远的天空底下
执迷不悔 (国语)	王菲	执迷不悔
听说你在上海	袁惟仁	木吉他
旋木	王菲	将爱
既然爱过	袁惟仁	你不知道的我
征服	那英	征服
勇敢一点 (Live)		蒙面唱将猜猜猜第二季 第7期
爱如潮水	张信哲	绝对收藏2
过火 (国语)	张信哲	宽容
信仰	张信哲	信仰
别怕我伤心	张信哲	等待
爱就一个字	张信哲	我好想
从开始到现在	张信哲	从开始到现在
有一点动心	张信哲	张信哲精选
太想爱你	张信哲	绝对想念
难以抗拒你容颜	张信哲	知道
白月光	张信哲	下一个永远
爱你没错	张信哲	还爱
不要对他说	张信哲	绝对想念
宽容	张信哲	宽容
说谎	张信哲	做你的男人
做你的男人	张信哲	做你的男人
信仰 + 演员 + 爱如潮水 (Live)	薛之谦|张信哲	挑战者联盟 “畅响盛典”演唱会
背叛 (Live)	张信哲	嗨，唱起来  第9期
情非得已 (Live)	张信哲	嗨，唱起来  第9期
平凡之路 + See You Again (Live)	张信哲	我是歌手第四季 第9期: 踢馆赛
我是真的爱你	张信哲	拥有
兄弟抱一下	庞龙	美好
你是我的玫瑰花	庞龙	你是我的玫瑰花
两只蝴蝶	庞龙	两只蝴蝶
幸福的两口子	庞龙	兄弟干杯
兄弟干杯	庞龙	兄弟干杯
家在东北	庞龙	两只蝴蝶
杯水情歌	庞龙	两只蝴蝶
我要抱着你	庞龙	你是我的玫瑰花
吹眼睛	庞龙	杯水情歌
星星照亮回家的路	庞龙	星星照亮回家的路
单身歌	庞龙	空
家的味道	庞龙	我们在蓝色海上飘
男人的累、男人的泪	庞龙	男人的泪
人在世上飘	庞龙	两只蝴蝶
幸福的两口子	庞龙	但愿人长久
最亲爱亲爱的老婆	庞龙	空
兄弟抱一下 (Live)	庞龙	空
校花	庞龙	真的不同了
爱情果	庞龙	爱情果
美丽的姑娘	庞龙	美丽的姑娘
万水千山总是情	汪明荃	万水千山总是情 电视剧原声带
京华春梦	汪明荃	京华春梦
用爱将心偷	汪明荃	千王之王
鹊桥仙 (Live)	汪明荃	经典咏流传 第3期
爱你一世一生	汪明荃	京华春梦
扑蝶	汪明荃	京华春梦
今生不负爱	汪明荃	京华春梦
紫钗恨	汪明荃	汪明荃演唱会
潇洒走一回	汪明荃	K歌单曲合集
采茶山歌	汪明荃	采茶山歌
一生几多情份	汪明荃	万水千山总是情 电视剧原声带
伴你过一世	汪明荃	万水千山总是情 电视剧原声带
千王之王	汪明荃	电视主题金曲精选
爱你一生不够多	汪明荃	京华春梦
并蒂花	汪明荃	帝女花 电视剧原声带
家乡	汪明荃	京华春梦
郎归晚	汪明荃	郎归晚
迎春花	汪明荃	欢乐年年
追忆当日爱	汪明荃	京华春梦
问候	汪明荃	美丽的时光·我像小雨
不爱我就拉倒	周杰伦	不爱我就拉倒
告白气球	周杰伦	周杰伦的床边故事
等你下课(with 杨瑞代)	周杰伦	等你下课
稻香	周杰伦	魔杰座
晴天	周杰伦	叶惠美
七里香	周杰伦	七里香
青花瓷	周杰伦	我很忙
简单爱	周杰伦	范特西
给我一首歌的时间	周杰伦	魔杰座
夜曲	周杰伦	十一月的萧邦
彩虹	周杰伦	我很忙
蒲公英的约定	周杰伦	我很忙
搁浅	周杰伦	七里香
退后	周杰伦	依然范特西
听妈妈的话	周杰伦	依然范特西
烟花易冷	周杰伦	跨时代
说好的幸福呢	周杰伦	魔杰座
一路向北	周杰伦	J III MP3 Player
最长的电影	周杰伦	我很忙
半岛铁盒	周杰伦	八度空间
青藏高原	李娜	青藏高原
苦乐年华	李娜	深深思念纪念专集
南无阿弥陀佛	李娜	美丽新世界
辘轳女人井	李娜	空
嫂子颂	李娜	青藏高原
篱笆墙的影子	李娜	影视音乐的摇篮
苦篱笆	李娜	深深思念纪念专集
黄土高坡	李娜	金曲精选珍藏版
女人是老虎	李娜	青藏高原
好人一生平安	李娜	青藏高原
信天游	李娜	金曲精选珍藏版
人间终有真情在	李娜	百年珍藏
你家在哪里	李娜	青藏高原
未了情	李娜	深深思念纪念专集
杜十娘	李娜	空
我热恋的故乡	李娜	影视歌曲集（中国首张DTS）珍藏版
说聊斋	李娜	百年珍藏
人在旅途	李娜	难忘的影视金曲 港台篇
武则天	李娜	青藏高原
阿里山的姑娘	李娜	信天游
大海	张雨生	大海
一天到晚游泳的鱼	张雨生	一天到晚游泳的鱼
我的未来不是梦	张雨生	张雨生的世界
最爱的人伤我最深	张惠妹|张雨生	两伊战争
天天想你	张雨生	天天想你
还是朋友	张雨生	还是朋友
我期待	张雨生	卡拉OK·台北·我
永远不回头	张雨生|王杰|邰正宵	自由歌
我是一棵秋天的树	张雨生	大海
最爱的人伤我最深	张雨生|张惠妹	K歌情人雅座
烈火青春	张雨生	自由歌
一生陪你走	张雨生	还是朋友
后知后觉	张雨生	卡拉OK·台北·我
还是朋友	张雨生	离别之后
执着	张雨生	还是朋友
和天一样高	张雨生	天天想你
是否真的爱我	张雨生	一天到晚游泳的鱼
我期待	张雨生	K歌情人雅座
一人一个梦	张雨生	一天到晚游泳的鱼
I Don't Wanna Say Goodbye	张雨生	大海
如约而至	许嵩	如约而至
明智之举	许嵩	明智之举
有何不可	许嵩	自定义
清明雨上	许嵩	Vae新歌+精选珍藏合辑
断桥残雪	许嵩	Vae新歌+精选珍藏合辑
素颜	许嵩	素颜
庐州月	许嵩	寻雾启示
灰色头像	许嵩	寻雾启示
玫瑰花的葬礼	许嵩	Vae新歌+精选珍藏合辑
幻听	许嵩	梦游计
城府	许嵩	Vae新歌+精选珍藏合辑
半城烟沙	许嵩	半城烟沙
惊鸿一面	许嵩	不如吃茶去
多余的解释	许嵩	自定义
我乐意	许嵩	我乐意
你若成风	许嵩	Vae新歌+精选珍藏合辑
千百度	许嵩	苏格拉没有底
山水之间	许嵩	不如吃茶去
雅俗共赏	许嵩	青年晚报
认错	许嵩	自定义
怎么说我不爱你	萧敬腾	狂想曲
王妃	萧敬腾	王妃
会痛的石头	萧敬腾	王妃
新不了情	萧敬腾	爱的时刻自选辑
王妃 2.0	萧敬腾	欲望反光
欲望反光	萧敬腾	欲望反光
我有多么喜欢你	萧敬腾|林宥嘉	欲望反光
阿飞的小蝴蝶	萧敬腾	王妃
我有多么喜欢你 (独唱版)	萧敬腾	欲望反光
迷茫世代	萧敬腾	欲望反光
海芋恋	萧敬腾	萧敬腾 同名专辑
我在人民广场吃炸鸡 (Live)	萧敬腾	梦想的声音 第2期
如果没有你	萧敬腾	爱的时刻自选辑
王子的新衣	萧敬腾	萧敬腾 同名专辑
让我为你唱情歌	萧敬腾	欲望反光
你会在哪呢？	萧敬腾	欲望反光
斗罗大陆	萧敬腾	斗罗大陆
Marry Me	萧敬腾	以爱之名
我怀念的	萧敬腾	爱的时刻自选辑
全是爱	萧敬腾	欲望反光
让我留在你身边	陈奕迅	让我留在你身边
我们	陈奕迅	我们
不要说话	陈奕迅	不想放手
十年	陈奕迅	黑白灰
渐渐	陈奕迅	渐渐
红玫瑰	陈奕迅	认了吧
好久不见	陈奕迅	认了吧
富士山下	陈奕迅	What's Going On…?
陪你度过漫长岁月 (国语)	陈奕迅	陪你度过漫长岁月
淘汰	陈奕迅	认了吧
单车	陈奕迅	Shall We Dance? Shall We Talk!
爱情转移	陈奕迅	爱情呼叫转移
浮夸	陈奕迅	U-87
阴天快乐	陈奕迅	rice & shine
K歌之王 (国语)	陈奕迅	反正是我
K歌之王 (粤语)	陈奕迅	打得火热
你的背包	陈奕迅	Special Thanks To…
孤独患者	陈奕迅	?
最佳损友	陈奕迅	Life Continues…
稳稳的幸福	陈奕迅	稳稳的幸福
不让我的眼泪陪我过夜	齐秦	狼 97黄金自选辑
大约在冬季	齐秦	燃烧爱情（狼之旅）
往事随风	齐秦	狼 97黄金自选辑
夜夜夜夜	齐秦	狼 97黄金自选辑
外面的世界	齐秦	燃烧爱情（狼之旅）
无情的雨无情的你	齐秦	狼 97黄金自选辑
原来的我	齐秦	10年朋友 9
狼	齐秦	狼的专辑
火柴天堂	齐秦	Chyi Chin
花祭	齐秦	狼Ⅰ
张三的歌 (Live)	齐秦	谁是大歌神 欢唱嘉年华
狂流	齐秦	狼Ⅰ
如果云知道 (Live)	齐秦	我是歌手第一季 第4期
月亮代表我的心	齐秦	旷世情歌全记录
思念是一种病	齐秦	辉煌30年
悬崖	齐秦	旷世情歌全记录
广岛之恋 (Live)	齐秦|莫文蔚	齐秦 莫文蔚：洛杉矶演唱会
无情的雨 无情的你	齐秦	国语经典101
冬雨	齐秦	狼Ⅰ
袖手旁观	齐秦	旷世情歌全记录
心墙	郭静	在树上唱歌
下一个天亮	郭静	下一个天亮
陪着我的时候想着她	郭静	陪着我的时候想着她
在树上唱歌	郭静	在树上唱歌
我不想忘记你	郭静	我不想忘记你
每一天都不同	郭静	你 朋友
拥抱你的微笑	郭静	我们都能幸福着
你的香气	郭静	我不想忘记你
可惜	郭静	这一切还是迷人的
别惹哭我	郭静	我们曾相爱
不药而愈	郭静	下一个天亮
总算我们也爱过	郭静	你 朋友
离开	郭静	陪着我的时候想着她
单身美好	郭静	我们都能幸福着
我们都能幸福着	郭静	我们都能幸福着
仨人	郭静|张韶涵|范玮琪	我不想忘记你
你眼中的我	郭静	致纯静 新歌+精选
往未来飞的客机	郭静	陪着我的时候想着她
回忆的阁楼	郭静	我们都能幸福着
聊天	郭静	你 朋友
信天游	杭天琪	空
唱脸谱	杭天琪	一人一首成名曲9
前门情思大碗茶	杭天琪	空
黄土高坡	杭天琪	空
走西口	杭天琪	1988西北风2
我热恋的故乡	杭天琪	空
一个真实的故事	杭天琪	不要那样看着我
永远是朋友	杭天琪	空
黄土高坡 + 我热恋的故乡 + 信天游 (Live)	杭天琪	空
黄河源头	杭天琪	军旅词作家石顺义作品选
黑头发飘起来	杭天琪	空
我依然爱你	杭天琪	我依然爱你
打虎上山	杭天琪	空
哥哥把你栓在心头	杭天琪|臧天朔	空
月残花烛泪	杭天琪	武则天
唱脸谱 + 前门情思大碗茶 (Live)	杭天琪	围炉音乐会 第6期
心愿 (Live)	杭天琪	围炉音乐会 第6期
红塔山下阿诗玛	杭天琪	空
西北风	杭天琪	西北风
遥远的思念	杭天琪	20世纪中华歌坛名人百集珍藏版
给女儿的一封信	张杰	给女儿的一封信
三生三世	张杰	三生三世十里桃花 电视剧原声带
只要平凡	张杰	只要平凡
逆战	张杰	One Chance 新歌+精选
我们都一样 (Live)	张杰	中国新声代第三季 第13期
仰望星空 (Live)	张杰	我想和你唱第三季 第6期
剑心	张杰	古剑奇谭 电视剧原声带
明天过后 (Live)	张杰	2016湖南卫视小年夜春晚
他不懂 (Live)	张杰	我想和你唱第三季 第6期
着魔	张杰	着魔
勿忘心安 (Live)	张杰	我是歌手第二季 第3期
你就不要想起我 (Live)	张杰	歌手 第8期
星辰	张杰	星辰
如歌	张杰	烈火如歌 电视剧原声带
逆态度	张杰	逆战 游戏原声带
他不懂 (Live)	张杰	我是歌手 双年巅峰会
好想大声说爱你 (Live)	张杰	快乐中国毕业歌会
夜空中最亮的星 (Live)	张杰	北京卫视2017跨年环球歌会
年轻的战场	张杰	空
我想	张杰	我想
爱一个人好难	苏永康	爱一个人好难
男人不该让女人流泪	苏永康	男人不该让女人流泪
越吻越伤心	苏永康	笑下去
那谁	苏永康	那谁
从不喜欢孤单一个	苏永康	It's All About Angela Pang
相遇太早	苏永康	苏情时间
我不是爱过就算的人	苏永康	爱一个人好难
爱似狂潮	苏永康	爱似狂潮
让懂你的人爱你	苏永康	解脱书
我为你伤心	苏永康	爱一个人好难
对你太在乎	苏永康|陈慧琳	CINEPOLY 25周年+ GO EAST 15周年经典101
有人为你偷偷在哭	苏永康	拥抱
性情中人	苏永康	性情中人
喜帖街	苏永康	大男人情歌
悲伤止步	苏永康	悲伤止步
忘了怎样说我爱你	苏永康	爱一个人好难
爱得正好	陈洁仪|苏永康	私房歌
越吻越伤心	陈洁仪|苏永康	私房歌
无法开口	苏永康	绿光森林 电视剧原声带
七友 (Live)	苏永康	安康演唱会
当有一天我老了	卢庚戌	当有一天我老了
我们生来就是孤独	卢庚戌	我的生命不过是温柔的疯狂
大鱼	卢庚戌	我的生命不过是温柔的疯狂
一生有你 (demo)	卢庚戌	未来的未来
蝴蝶花	卢庚戌	未来的未来
未来的未来	卢庚戌	未来的未来
我的生命不过是温柔的疯狂	卢庚戌	我的生命不过是温柔的疯狂
没有人比我更爱你 (demo)	卢庚戌	未来的未来
你是我的孤独	卢庚戌	阿弥陀佛么么哒·一个孩子的心愿
九月	卢庚戌	九月
时间的玫瑰	卢庚戌	我的生命不过是温柔的疯狂
借我一生 (demo)	卢庚戌	未来的未来
致爱人	卢庚戌	我的生命不过是温柔的疯狂
每一次呼吸	卢庚戌	怒放2013 电影原声带
我知道	卢庚戌	我知道
我没有自己的名字	卢庚戌	未来的未来
情诗	卢庚戌	我的生命不过是温柔的疯狂
夜风	卢庚戌	未来的未来
老屋 (demo)	卢庚戌	未来的未来
纸婚	卢庚戌	未来的未来
轻轻的告诉你	杨钰莹	月亮船
茶山情歌	杨钰莹	风含情水含笑
心雨	毛宁|杨钰莹	能有几次这样的爱
风含情水含笑	杨钰莹	风含情水含笑
我不想说 (新编曲版)	杨钰莹	SK杨钰莹
我在春天等你	杨钰莹	遇江南
心相印手牵手	杨钰莹	风含情水含笑
桃花运	杨钰莹	风含情水含笑
梦醒时分	杨钰莹	我有一段情
等你一万年	杨钰莹	中华歌坛名人: 杨钰莹
我悄悄地蒙上你的眼睛	毛宁|杨钰莹	金童玉女浓情对唱
千千阙歌 (Live)	杨钰莹	2017湖南卫视快乐中国跨年演唱会
甜蜜蜜	杨钰莹	君心似我心
你若安好 便是晴天	杨钰莹	遇江南
其实你不懂我的心	杨钰莹	不了情
天涯歌女	杨钰莹	君心似我心
轻轻地告诉你	杨钰莹	中华歌坛名人: 杨钰莹
甜甜小妹	杨钰莹	为爱祝福
风中有朵雨做的云 (Live)	孟庭苇|杨钰莹	天下无双
泉水叮咚	杨钰莹	妈妈留给我一首歌
星辰大海是你	魏晨	那片星空那片海第二季 电视原声带
封面恋人	魏晨	中国音乐电视
我为自己代言	魏晨	我为自己代言
雨痕	魏晨	一起又看流星雨 电视剧原声带
尘埃 (Live)	魏晨	2013湖南卫视春晚
不变	魏晨	旅程
烈火神盾	魏晨	烈火神盾
旅程	魏晨	旅程
白日梦想家	魏晨	白日梦想家
天下有情人	魏晨	郁可唯电子唱片
帽子戏法 (Live)	魏晨	2015湖南卫视跨年演唱会
我们在改变 (Live)	魏晨	帽子戏法 首唱见面会
破晓 (Live)	魏晨	湖南卫视2012跨年演唱会
Goodbye Goodbye (Live)	魏晨	湖南卫视2012跨年演唱会
Where Went Yesterday	魏晨	白日梦想家 I
重返十七岁 (新版)	薛之谦|魏晨|潘玮柏	重返十七岁（新版）
没有到不了的地方	魏晨	白日梦想家 II
复杂人生	魏晨	旅程
Run Away	魏晨	Run Away
手放开 (Live)	魏晨	空
没那么简单	黄小琥	简单/不简单
重来	黄小琥	如果能...重来
顺其自然	黄小琥	如果能...重来
伴	黄小琥	简单/不简单
你把我灌醉	黄小琥	The Voice 3：L.V 醉爱情歌全辑
白天不懂夜的黑	黄小琥	The Voice 2：琥魅人生
新不了情	黄小琥	璀璨百分百
不只是朋友	黄小琥	不只是朋友
该放手了	黄小琥	愈爱愈明白
你怎么舍得我难过	黄小琥	The Voice 3：L.V 醉爱情歌全辑
突然的自我	黄小琥	The Voice 3：L.V 醉爱情歌全辑
心酸的成熟	黄小琥	爱情原来没什么
你是我的眼 (Live)	黄小琥	2008黄小琥世界巡回演唱会
我的心里只有你没有他	黄小琥	原汁原味-2005超女翻唱篇
放心不下	黄小琥	放心不下
没那么简单 (Live)	黄小琥	不凡的改变 第3期
不该那么想你	黄小琥	寂寞女子
我的歌声里 (Live)	黄小琥	第一期 摇滚之夜
最爱的人	黄小琥	简单/不简单
勇敢说再见	黄小琥	勇敢说再见
想太多	李玖哲	想太多
夏天	李玖哲	好玖
解脱	李玖哲	影子
我会好好过	李玖哲	Baby是我
只牵你的手	李玖哲	Baby是我
不，完美	李玖哲	不，完美
都怪我	李玖哲	影子
死结	李玖哲	不，完美
围墙	李玖哲	想太多
最后的那一天	李玖哲	好玖
别说	李玖哲	不，完美
还会记得我吗	李玖哲	还会记得吗
Right Here Waiting	李玖哲	好玖
不爱了	李玖哲	好玖
Making Love Out Of Nothing At All	李玖哲	好玖
爱不需要理由	李玖哲	想太多
做你的天	李玖哲	想太多
影子	李玖哲	影子
Baby是我	李玖哲	Baby是我
再见	李玖哲	Baby是我
白色恋人	游鸿明	诗人的眼泪
爱我的人和我爱的人	游鸿明	恋上一个人
下沙	游鸿明	下沙
孟婆汤	游鸿明	五月的雪
一天一万年	游鸿明	一天一万年
恋上一个人	游鸿明	恋上一个人
诗人的眼泪	游鸿明	诗人的眼泪
楼下那个女人	游鸿明	世界太冷漠
爱一回伤一回	游鸿明	爱一回伤一回
恋上另一个人 (悔不当初版)	游鸿明	恋上游鸿明
五月的雪	游鸿明	五月的雪
地下铁	游鸿明	地下铁
我们这里还有鱼	游鸿明	魔霆痴狂之霆锋当道
21个人	游鸿明	下沙
你连笑起来都不快乐	游鸿明	一天一万年
寻你	游鸿明	下沙
倦鸟余花	游鸿明	倦鸟余花
你微笑时好美	游鸿明	倦鸟余花
我的爱情被你烧成灰	游鸿明	一天一万年
第一千个昼夜	游鸿明	2004秋季恋歌第一千个昼夜
最终信仰	尚雯婕	atypical 异类
鹿 be free	尚雯婕	鹿 be free
Befall	尚雯婕	Befall
木兰诗 (Live)	尚雯婕	经典咏流传 第3期
Will You	尚雯婕	Will You
待我长发及腰	尚雯婕	美人制造 电视剧原声带
big up 咆哮	尚雯婕	Black & Golden 黑金
生命的盛宴 2018	尚雯婕	生命的盛宴 2018
King Of Stupidity	尚雯婕	King Of Stupidity
你怎么舍得我难过	尚雯婕	非诚勿扰
Love Warrior 战	尚雯婕	Nightmare
free & unafraid 自由与勇敢	尚雯婕	free & unafraid 自由与勇敢
候鸟	尚雯婕	全球风靡 Fashion Icon
小星星	尚雯婕	Graceland
女王驾到	尚雯婕	女王驾到
阿修罗	尚雯婕	阿修罗
时间的力量 time will tell	尚雯婕	Black & Golden 黑金
最终信仰 (Live)	尚雯婕	我是歌手第一季 第1期
花火	尚雯婕	非诚勿扰
夜夜夜夜	尚雯婕	非诚勿扰
我很快乐	刘惜君	爱情花园
菩提偈	刘惜君	独孤天下 电视剧影视原声
美丽心情	刘惜君	美丽心情
遥远的歌	刘惜君	你好，旧时光 连续剧原声带
怎么唱情歌	刘惜君	拂晓
线	刘惜君	因为遇见你 电视剧原声带
我只在乎你	刘惜君	惜·君
醉里红尘	刘惜君	醉玲珑 电视剧原声带
那时候的我	刘惜君	拂晓
此时彼岸	刘惜君	我站在桥上看风景 电视剧OST原声专辑
不期而遇	刘惜君	不期而遇
贝壳风铃	刘惜君	Sara
漫步人生路	刘惜君	惜·君
芬芳一生 (Live)	刘惜君	明日之子 第13期
爱别离	刘惜君	爱别离
御龙品青梅	刘惜君	御龙在天 游戏原声带
南海姑娘	刘惜君	惜·君
原上草	刘惜君	原上草
亲爱的小孩 (Live)	刘惜君	空
快乐女孩	刘惜君	快乐女孩
你要的爱 (深夜版)	戴佩妮	你要的爱（深夜版）
怎样	戴佩妮	怎样
街角的祝福	戴佩妮	Just Sing It
辛德瑞拉	戴佩妮	So Penny
原谅我就是这样的女生	戴佩妮	原谅我就是这样的女生
一个人的行李	戴佩妮	iPenny
爱疯了	戴佩妮	爱疯了
一念之间	戴佩妮	我到底是谁？
防...空洞	戴佩妮	So Penny
路	戴佩妮	Just Sing It
小小	戴佩妮	iPenny
我们的故事	戴佩妮	iPenny
贼	戴佩妮	贼
Amen	戴佩妮	爱疯了
无赖	戴佩妮	纯属意外
光着我的脚丫子	戴佩妮	回家路上
两难	戴佩妮	原谅我就是这样的女生
多么想念你	戴佩妮	回家路上
窗外	戴佩妮	iPenny
单身潜逃	戴佩妮	iPenny
May Rain	窦靖童	May Rain
(It's not a crime) It's just what we do	窦靖童	(It's not a crime) It's just what we do
My Days	窦靖童	Stone Café
See You Again	窦靖童	See You Again
With You	窦靖童	With You
Blue Flamingo	窦靖童	Stone Café
The Way	窦靖童	Stone Café
River Run	窦靖童	River Run
Wu	窦靖童	Kids Only
Brother	窦靖童	Brother
Kids only	窦靖童	Kids Only
Jungle Pink	窦靖童	Kids Only
I Don't Trust Myself	窦靖童	空
Blooming	窦靖童	Kids Only
Bitter Sweet	窦靖童	Stone Café
July	窦靖童	Kids Only
On The Beach (抢听版)	窦靖童	空
粉色丛林 (Live)	窦靖童	 
Whistler's Riddle	窦靖童	Kids Only
Explosions	窦靖童	Stone Café
爱不爱我 (Live)	周晓鸥	我是歌手第一季 第5期
无地自容 (Live)	周晓鸥	我是歌手第一季 第8期
无情的雨无情的你 (Live)	周晓鸥	我是歌手第一季 第7期
拥抱	周晓鸥	还是夫妻 电视剧原声带
让爱从头	周晓鸥	男人帮 电视剧原声带
粉墨人生 (Live)	周晓鸥	跨界歌王 总决赛
如果我是梁山伯	周晓鸥	如果我是梁山伯
天空 (Live)	周晓鸥	我是歌手第一季 第6期
离开即归来	周晓鸥	离开即归来
爱情宣言 + 九个太阳 (Live)	周晓鸥	我是歌手第一季 第10期
天下没有不散的筵席 (Live)	周晓鸥|谭维维	我是歌手第一季 总决赛
爱不爱我 (Live)	周晓鸥	厉害了！我的歌 第3期
流星无悔 (Live)	周晓鸥	我是歌手第一季 第12期
不再掩饰 (Live)	周晓鸥	我是歌手第一季 第9期
拯救 (Live)	周晓鸥	诗歌之王 第一期
旁边	周晓鸥	旁边
青春啊青春 (Live)	周晓鸥	诗歌之王 第三期
漫漫江湖游 (Live)	周晓鸥	诗歌之王 第十二期
Everything I do (Live)	周晓鸥	我是歌手第一季 总决赛
奔跑	周晓鸥	奔跑
追梦人	凤飞飞	一起飞
月朦胧 鸟朦胧	凤飞飞	琼瑶影视作品
掌声响起	凤飞飞	经典金曲VOL.4
爱你在心口难开	凤飞飞	绝色小号 因为我爱你
我是一片云	凤飞飞	我是一片云
往事难追忆	凤飞飞	凤飞飞金唱片第一集
潇洒的走	凤飞飞	凤飞飞作品集
春风吻上我的脸	凤飞飞	春风吻上我的脸-怀念歌曲(二)
天涯歌女	凤飞飞	民歌小调
蝶恋花	凤飞飞	凤情千千万
莫让红颜守空尘	凤飞飞	雪山飞狐 电视剧原声带
姑娘十八一朵花	凤飞飞	群星会20-凤飞飞
片片枫叶片片情	凤飞飞	落叶飘飘
南屏晚钟	凤飞飞	春风吻上我的脸-怀念歌曲(二)
今宵多珍重	凤飞飞	凤飞飞精选集-2
绿岛小夜曲	凤飞飞	春风吻上我的脸-怀念歌曲(二)
知己	凤飞飞	什么样的你
相思河畔	凤飞飞	意难忘
往事如烟	凤飞飞	爱的奇迹
好好爱我	凤飞飞	走过岁月6CD传家典藏
红颜劫	姚贝娜	姚贝娜影视音乐精选辑
鱼 (Live)	姚贝娜	空
战争世界	姚贝娜	1/2的我
随它吧	姚贝娜	Let It Go The Complete Set
时间都去哪儿了	姚贝娜	时间都去哪儿了
矜持	姚贝娜	矜持
画情	姚贝娜	画情
菩萨蛮	姚贝娜	姚贝娜影视音乐精选辑
至少还有你	姚贝娜	大丈夫 电视剧原声带
心火	姚贝娜	1/2的我
也许明天 (Live)	姚贝娜	跨年演唱会2013-2014 华语篇
惊鸿舞	姚贝娜	姚贝娜影视音乐精选辑
御龙吟	姚贝娜	姚贝娜影视音乐精选辑
阆中之恋	姚贝娜|沙宝亮	阆中之恋
采莲	姚贝娜	姚贝娜影视音乐精选辑
如果没有你	姚贝娜	天生骄傲
金缕衣	姚贝娜	姚贝娜影视音乐精选辑
天耀中华 (Live)	姚贝娜	2014央视春晚
可以不可以	姚贝娜	姚贝娜 同名专辑
Beautiful Light	姚贝娜	Beautiful Light
好心分手	卢巧音	赏味人间
三角志	卢巧音	4 Seasons In One Day
落地开花	卢巧音	花言.巧语
垃圾	卢巧音	不需要…完美得可怕
喜欢恋爱	卢巧音	喜欢恋爱 (新曲+精选)
风吹不走笑容	卢巧音	花言.巧语
好心分手	王力宏|卢巧音	2 Love 致情挚爱
逆插玫瑰	卢巧音	花言.巧语
至少走的比你早	卢巧音	赏味人间
花奴	卢巧音	花言.巧语
好心分手 (合唱版)	卢巧音|王力宏	赏味人间
深蓝	卢巧音	色放
天佑我们	卢巧音	4 Seasons In One Day
去你的婚礼	卢巧音	Fantasy
喜欢恋爱	卢巧音	4 Seasons In One Day
乱世佳人	卢巧音	赏味人间
佛洛伊德爱上林夕	卢巧音	Muse
命犯桃花	卢巧音	花言.巧语
至少走得比你早	卢巧音	非同寻常 陆毅的音乐告白
好心分手	王力宏|卢巧音	力宏二十 20周年唯一精选
情网	任静	情网
知心爱人	任静	知心爱人
无情相思无情泪	任静	甜歌精选
真是太傻	任静	情网
无望的痴情	任静	情网
错误的爱	任静	情人胜地
只好把你遗忘	任静	情网
你是幸福的 我是快乐的	任静	10年精品对唱 珍藏版
叫我去问谁	任静	情网
孤寂的心	任静	情网
不再梦见你	任静	空
风飞沙	任静	情网
观音菩萨在心中	任静	海上莲花
爱情一百年	任静	10年精品对唱 珍藏版
爱的沧桑	任静	情网
雨中恋	任静	情歌天下-黑胶精品
爱的誓言	任静	甜歌精选
我今生最爱的人	任静	我今生最爱的人
当你老了 (Live)	任静	中央电视台2016中秋晚会
极乐世界是我家	任静	空
当你孤单你会想起谁	张栋梁	首选
北极星的眼泪	张栋梁	王子
小乌龟	张栋梁	十年有成精选
痛彻心扉	张栋梁	主打
错了再错	张栋梁	王子
只因为你	张栋梁	主打
王子	张栋梁	王子
就微笑了	张栋梁	微笑Pasta 电视剧原声带
黄昏	张栋梁	首选
寂寞边界	张栋梁	首选
说你也一样爱着我	张栋梁	沉默的瞬间
别再惊动爱情	张栋梁	别再惊动爱情
错爱	张栋梁	From Now On 新歌+精选
怎么会哭	张栋梁	别再惊动爱情
沉默的瞬间	张栋梁	沉默的瞬间
陌路	张栋梁	王子
世界上最爱你的人	张栋梁	别再惊动爱情
爱你胜过自己	张栋梁	沉默的瞬间
新歌试唱	张栋梁	From Now On 新歌+精选
刚好的幸福	张栋梁	K歌情人梦 电视剧原声带
爸爸妈妈	王蓉	多爱
哎呀	王蓉	多爱
小鸡小鸡	王蓉	小鸡小鸡
我不是黄蓉	王蓉	我不是黄蓉
坏姐姐	王蓉	坏姐姐
要抱抱	王蓉	要抱抱
好乐Day	王蓉	好乐Day
芙蓉姐夫	王蓉	芙蓉姐夫
火了火了火	王蓉	火了火了火(为奥运喝彩)
般若波罗蜜多心经	王蓉	空
水煮鱼	王蓉	多爱
抖抖傲	王蓉	抖抖傲
红烧肉	王蓉	红烧肉
鲨鱼鲨鱼	王蓉	鲨鱼鲨鱼
啪啪S舞	王蓉	啪啪S舞
加倍	王蓉	加倍
爱似神仙	王蓉	多爱
三生三世	王蓉	剑侠情缘2
我不是美女	王蓉	多爱
爱爱不爱	王蓉	爱爱不爱
让一切随风	钟镇涛	听涛
只要你过得比我好	钟镇涛	诗人与情人
大海	钟镇涛	全部为你
漫漫人生路	钟镇涛	漫漫人生路
漫漫人生路	钟镇涛	简简单单的生活
梅花烙	叶倩文|钟镇涛	叶倩文合唱金曲经典
曾经	钟镇涛	林夕字传
谁是大英雄	钟镇涛|谭维维	空
Sha La-La-La-La (Live)	钟镇涛	Priscilla-ism Live 2016
红叶…斜落我心寂寞时	钟镇涛	看星的日子
爱得忘了自己	钟镇涛	情人的眼睛
一段情 (Live)	钟镇涛|谭咏麟	温拿Never Say Goodbye演唱会2016
无言感激 (Live)	谭咏麟|钟镇涛	宝丽金15周年演唱会
其实我没有那么坚强	钟镇涛	男人
香肠蚊帐机关枪	钟镇涛	宝丽金88极品音色系列
飘	钟镇涛	飘
一个错误	钟镇涛	简简单单的生活
等你	钟镇涛	真经典 - 钟镇涛
让我坦荡荡	钟镇涛	不可以不想你
不可以不想你	钟镇涛	不可以不想你
爱情鸟	林依轮	爱情鸟
透过开满鲜花的月亮	林依轮	爱情鸟
火火的歌谣	林依轮	火火的歌谣
向快乐出发	林依轮	向快乐出发
带上你的故事跟我走	林依轮	爱情贵族
步步高	景岗山|林依轮	空
爱在2000	林依轮	爱在2000
快乐老家 (Live)	林依轮	不凡的改变 第7期
锣鼓	林依轮	林依轮精选集
月圆花好	林依轮	月圆花好
靠近你，温暖我	林依轮	欢乐音雄
我只想好好爱你	林依轮	爱在2000
北京童谣	林依轮	北京童谣
最后的温柔	林依轮	爱情鸟
心动	林依轮	爱情鸟
向快乐出发 (独唱版)	林依轮	向快乐出发
美丽的传说	林依轮	爱情贵族
月亮湾	林依轮	欢乐音雄
一路同行	林依轮	 
爱上一个人是你	林依轮	爱情鸟
In Control	孟楠	我只有我
领悟 (Live)	孟楠	梦响新歌声-香港站
痒	孟楠	我来自梦
软肋	孟楠	我来自梦
白月光 (Live)	孟楠	梦响新歌声-香港站
我只有我	孟楠	我只有我
别让爱情走了样	孟楠	我只有我
痒2018	孟楠	痒2018
爱情不过那么回事	孟楠	我只有我
痒（更痒）	孟楠	痒2018
硬邦邦	孟楠	硬邦邦
In Control (铃声)	孟楠	
一起摇摆 (Live)	孟楠	光荣绽放
爱 (铃声)	孟楠	
问 (2013中国好声音第二季中秋特辑现场)	孟楠	 
爱上你不可惜	孟楠	空
迟到	孟楠	我只有我
握住我的手	孟楠	我只有我
弯弯的月亮 + 存在 + 刀剑如梦 + 飞的更高 (Live)	孟楠	完美星开幕 第9期
我来自梦	孟楠	我来自梦
归来	满江	第三季中国好歌曲导师大碟——羽泉组
Mr.Man	满江	第三季中国好歌曲导师大碟——羽泉组
Mr.Man (Live)	满江|韩红	中国好歌曲第三季 总决赛
飞鸟	满江	飞鸟
我们之间	满江	四舍五入
裙角飞扬	满江	秘密花园
奇迹 (你相信吗？)	满江	奇迹
心碎北京	满江	心碎北京
最后的温柔	满江	最后的温柔
烟火	满江	烟火
黑暗中舞蹈	满江	Mr.Man
你是春风我是雨	满江	多变的海
当我们聊到未来的时候，未来就过去了	满江	当我们聊到未来的时候，未来就过去了
中华诵	满江	空
最美的时光	满江	最美的时光
阳光下	满江	Mr.Man
等	满江	Mr.Man
四舍五入	满江	四舍五入
恋爱中的城市	满江	奇迹
我的梦	满江	Mr.Man
多情的土地	廖昌永	海恋
天边	廖昌永	极品名声＆中音王
父亲的草原母亲的河	廖昌永	情释
那就是我	廖昌永	海恋
我爱你，中国	廖昌永	怀念
我和我的祖国	廖昌永	凝聚
月满西楼	廖昌永	情释
莫斯科郊外的晚上	廖昌永	俄罗斯经典歌曲
共和国之恋	廖昌永	凝聚
山楂树	廖昌永	俄罗斯经典歌曲
在银色月光下	廖昌永	情缘
草原夜色美	廖昌永	海恋
映山红	廖昌永	山丹丹花开
驼铃	廖昌永	怀念
小路	廖昌永	俄罗斯经典歌曲
老师我总是想起你 (Live)	廖昌永	空
红梅花儿开	廖昌永	俄罗斯经典歌曲
海恋	廖昌永	海恋
江河万古流	廖昌永	凝聚
乡愁	廖昌永	情缘
朋友别哭	吕方	相亲相爱
老情歌	吕方	多爱你一天
多爱你一天	吕方	多爱你一天
流浪花	吕方	流浪花
爱一回伤一回	吕方	爱一回伤一回
弯弯的月亮 (粤语)	吕方	弯弯的月亮
每段路	吕方	痴恋
听不到的说话	吕方	听不到的说话
只想遇到一个人	吕方	真•情歌（精选32首）
一帘幽梦	吕方	非常老情歌
弯弯的月亮 (国语)	吕方	弯弯的月亮
雪山飞狐	吕方	影视红声
天老情未老	吕方	不舍得你
你令我快乐过	吕方	听不到的说话
多爱你一天 (广东版)	吕方	流浪花
请你跟我走	吕方	恋爱季节经典13首
城里的月光	吕方	Touching Moment
爱的路上千万里	吕方	非常老情歌
只因我太痴	吕方	求你讲清楚
不舍得你	吕方	不舍得你
最重要的决定	范玮琪	Love and FanFan
最初的梦想	范玮琪	最初的梦想
一个像夏天一个像秋天	范玮琪	我们的纪念日
可不可以不勇敢	范玮琪	真善美
是非题	范玮琪	哲学家
到不了	范玮琪	范范的世界
那些花儿	范玮琪	真善美
如果的事	范玮琪|张韶涵	一比一
最亲爱的你	范玮琪	爱，在一起Together
我们的纪念日	范玮琪	我们的纪念日
黑白配	范玮琪	我们的纪念日
启程	范玮琪	真善美
悄悄告诉你	范玮琪	悄悄告诉你
一颗心的距离	范玮琪	Faces Of FanFan
蒲公英	范玮琪	蒲公英
我终于失去了你 (Live)	范玮琪	最美和声第一季 第3期
没那么爱他	范玮琪	Faces Of FanFan
很久很久以后	范玮琪	范范的感恩节
动物森林	范玮琪	范范的感恩节
温柔的奇迹	范玮琪	温柔的奇迹
恋曲1990	罗大佑	似曾相识 Ⅰ
你的样子	罗大佑	光阴的故事电视剧原声带
光阴的故事 (片头曲)	罗大佑	光阴的故事电视剧原声带
童年 (Live)	罗大佑	2015浙江卫视跨年演唱会
滚滚红尘	罗大佑|陈淑桦	港台影视怀旧金曲
皇后大道东 (Live)	罗大佑	情感万花筒演唱会(滚石香港十周年演唱会庆典)
沧海一声笑	罗大佑	10年朋友 10
光阴的故事		中国合伙人 电影原声带
鹿港小镇	罗大佑	超级星光PK宝典2
追梦人 (Live)	杨宗纬	嗨，唱起来  第4期
野百合也有春天 (Live)	罗大佑	异口同声 第11期
穿过你的黑发的我的手	罗大佑	似曾相识(二)
东方之珠	罗大佑	一起飞
童年 (Live)	罗大佑	异口同声 第11期
恋曲1990 (Live)	罗大佑	异口同声 第11期
爱的箴言 (Live)	罗大佑	精彩音乐汇
你的样子 (Live)	罗大佑	异口同声 第11期
沧海一声笑	罗大佑	2021爱你爱一百年原曲原唱天王天后情歌典藏
野百合也有春天 (Live)	罗大佑	隐藏的歌手第二季 王中王争霸战
之乎者也	罗大佑	10年朋友 1
我是不是该安静的走开	郭富城	郭富城2
对你爱不完	郭富城	对你爱不完
Para Para 樱之花	郭富城	爱•情大舞台
动起来	郭富城	旅途 愉快
爱的呼唤	郭富城	爱的呼唤
Para Para Sakura	郭富城	芭啦芭啦樱之花
狂野之城	郭富城	狂野之城
唱这歌 (粤语)	郭富城	唱这歌
听风的歌	郭富城	听风的歌
伤心的话留到明天再说	郭富城	对你爱不完
到底有谁能够告诉我	郭富城	到底有谁能够告诉我
风里密码	郭富城	风里密码
无忌 (粤语)	郭富城	无忌vs未来
我想偷偷对你说我爱你	郭富城	郭富城2
就是孙悟空	郭富城	就是孙悟空
永远爱不完	郭富城	永远爱不完
把所有的爱都留给你	郭富城	把所有的爱都留给你
铁幕诱惑	郭富城	铁幕诱惑
我要给你全部的爱	郭富城	到底有谁能够告诉我
爱的呼唤 (国语)	郭富城	爱定你
乡恋	李谷一	20世纪中华歌坛名人百集珍藏版
难忘今宵	李谷一	20世纪中华歌坛名人百集珍藏版
绒花	李谷一	妹妹找哥泪花流 电影插曲选
边疆的泉水清又纯	李谷一	20世纪中华歌坛名人百集珍藏版
年轻的朋友来相会	李谷一	难忘今宵
知音	李谷一	20世纪中华歌坛名人百集珍藏版
我和我的祖国	李谷一	我和我的祖国
妹妹找哥泪花流	李谷一	20世纪中华歌坛名人百集珍藏版
浏阳河	李谷一	中国著名男女对唱歌曲
前门情思大碗茶 (Live)	李谷一	2018央视元宵晚会
一条大河	李谷一	空
心中的玫瑰	李谷一	20世纪中华歌坛名人百集珍藏版
花儿为什么这样红	李谷一	影屏歌声（5）中外影视名曲之五
弹起我心爱的土琵琶	李谷一	太平洋_怀旧电影金曲
我爱你中国	李谷一	空
刘海砍樵	李谷一	20世纪中华歌坛名人百集珍藏版
故乡是北京	李谷一	歌曲精选
前门情思大碗茶	李谷一	20世纪中华歌坛名人百集珍藏版
长大后我就成了你	李谷一	长大后我就成了你
人说山西风光好	李谷一	太平洋_怀旧电影金曲
全世界谁倾听你	林宥嘉	全世界谁倾听你
我有多么喜欢你	萧敬腾|林宥嘉	欲望反光
成全 (Live)	林宥嘉	“17聚幸福”江苏卫视2017跨年演唱会
说谎 (Live)	林宥嘉	湘江音乐节
浪费 (Live)	林宥嘉	蒙面唱将猜猜猜 第11期
突然想起你 (Live)	林宥嘉	Senses Around Live Tour
残酷月光 (Live)	林宥嘉	异口同声 第4期
致姗姗来迟的你	林宥嘉	我愚蠢的理想主义
想自由 (Live)	林宥嘉	湘江音乐节
我爱的人 (Live)	林宥嘉	重返迷宫LIVE演唱会
心酸 (Live)	林宥嘉	湘江音乐节
船	林宥嘉	船
我只在乎你 (Live)	林宥嘉	Senses Around Live Tour
眼色 (Live)	林宥嘉	Senses Around Live Tour
感同身受 (Live)	林宥嘉	湘江音乐节
吻得太逼真 + 酷爱 (Live)	张敬轩|林宥嘉	903id club 拉阔音乐会2010第一场
说谎 (上Live)	林宥嘉	异口同声 第4期
再别康桥 (Live)	林宥嘉	感官/世界-私藏live影音特辑
浪费 (Live)	林宥嘉	异口同声 第4期
林宥嘉		林宥嘉
我乘着风飞过来	洪辰	熊出没之熊心归来 动画电影原声带
天高地厚 (Live)	洪辰	2011快乐女声八进七
勇往直前 (TV Version)	洪辰	空
等你的时候 我像个傻瓜 (Live)	洪辰	全球中文音乐榜上榜
恋爱咒语	魏晨|洪辰	恋爱咒语 电影原声带
不生气了，好吗	洪辰	不生气了，好吗
If I were a boy	洪辰	2011快乐女声九进八
无法原谅 (Live)	洪辰	湖南卫视2012跨年演唱会
至少还有你 (Live)	洪辰	2011快乐女声七进六
Firework	洪辰	2011快乐女声七进六
Nobody	洪辰	2011快乐女声四进三
离歌	洪辰	 
poker face	洪辰	2011快乐女声七进六
破晓&Umbrella Singing In The Rain	洪辰|魏晨	2011快乐女声决赛
狐狸叫 (Live)	洪辰	跨年演唱会2013-2014 华语篇
So what	洪辰	2011快乐女声九进八
Halo	洪辰	空
如果这就是爱情	洪辰	 
狼	洪辰	2011快乐女声四进三
爱情三十六计	洪辰	2011快乐女声五进四
千面	陈志朋	千面
诱惑YOHO	陈志朋	千面
祝你一路顺风	陈志朋	舍不得
爱	陈志朋	他和她·爱
红蜻蜓	陈志朋	他和她·爱
无路可退	陈志朋	千面
伤心的人别听慢歌 + 舞娘 (Live)	陈志朋	我是歌手第二季 总决赛
莫妮卡	陈志朋	舍不得
舍不得	陈志朋	舍不得
青苹果乐园	陈志朋	他和她·爱
他和她	陈志朋	他和她·爱
叫你一声 My Love (Live)	陈志朋	志爱一没人能取代记忆中的你 2016陈志朋北京演唱会
共同渡过	陈志朋	舍不得
女人花 (Live)	陈志朋	志爱一没人能取代记忆中的你 2016陈志朋北京演唱会
孤独成瘾	陈志朋	千面
好聚好散	陈志朋	快乐的感觉永远一样
记住你的香	陈志朋	心在想念
你的城市你的故事	陈志朋	心在想念
放心去飞 (Live)	陈志朋	志爱一没人能取代记忆中的你 2016陈志朋北京演唱会
过客	陈志朋	客家演歌
分手后不要做朋友	梁文音	分手后不要做朋友
爱一直存在	梁文音	爱，一直存在
最幸福的事	梁文音	爱的诗篇
哭过就好了	梁文音	爱，一直存在
满满	王铮亮|梁文音	爱，一直存在
很久很久以后	梁文音	爱，一直存在
我不是你想像那么勇敢	梁文音	爱的诗篇
还好	梁文音	副驾驶座的风景
不期而遇	梁文音	不期而遇
还是朋友	梁文音	情人X知己
最亲爱的	梁文音	爱的诗篇
三个愿望	梁文音	爱，一直存在
情人知己	梁文音	情人X知己
副驾驶座的风景	梁文音	副驾驶座的风景
薄荷与指甲剪	梁文音	爱的诗篇
可以不爱了	梁文音	爱的诗篇
转折	梁文音	副驾驶座的风景
和平分手	梁文音	副驾驶座的风景
我们都别哭	梁文音	情人X知己
心里的孩子	梁文音	黄色夹克
明天你是否依然爱我	童安格	其实你不懂我的心
其实你不懂我的心	童安格	其实你不懂我的心
把根留住	童安格	花瓣雨
借我一点爱	童安格	梦开始的地方
让生命等候	童安格	宝丽金88极品音色系列-童安格
耶利亚女郎	童安格	梦开始的地方
花瓣雨	童安格	花瓣雨
爱与哀愁	童安格	爱与哀愁
一世情缘	童安格	宝丽金88极品音色系列-童安格
忘不了	童安格	其实你不懂我的心
不必太在意	童安格	一世情缘
谢谢最深爱的你	童安格	现在以后
游戏人间	童安格	现在以后
别把我的心带走	童安格	收留
梦开始的地方	童安格	梦开始的地方
明天你是否依然爱我 (Live)	童安格|关淑怡	宝丽金二十周年演唱会
等我一起入梦	童安格	梦开始的地方
让生命等候 (Live)	童安格	童周共聚 2006童安格&周治平Live演唱会
一天一点爱恋 (Live)	童安格	童周共聚 2006童安格&周治平Live演唱会
伤感列车	童安格	一世情缘
雪候鸟	熊天平	雪候鸟
愚人码头	熊天平	爱情多恼河
火柴天堂	熊天平	一个人流浪
你的眼睛	熊天平|许茹芸	爱情多恼河
爱情多恼河	熊天平	爱情多恼河
夜夜夜夜 (DEMO)	熊天平	爱情多恼河
爱情电影	熊天平|许茹芸	一个人流浪
大雨带我逃亡	熊天平	雪候鸟
心有灵犀	熊天平	雪候鸟
相思无解	熊天平	爱情多恼河
一个人流浪	熊天平	一个人流浪
最后还是会	熊天平	最后还是会
心碎的冰咖啡	熊天平	最后还是会
I Wish	熊天平	最后还是会
爱情电影	许茹芸|熊天平	茹此精彩十三首
月亮森林	熊天平	雪候鸟
MR. Moon	熊天平	一个人流浪
我都在乎	熊天平	我都在乎
雪侯鸟	熊天平	1998上华国语总冠军
你的眼睛	许茹芸|熊天平	好歌茹芸
记事本	陈慧琳	闪亮每一天Shining新歌 + 精选
不如跳舞	陈慧琳	花花宇宙
Love Paradise	陈慧琳	sylish index
花花宇宙	陈慧琳	花花宇宙
都是你的错	陈慧琳	继续爱我
希望 (国语)	陈慧琳	我是阳光的
打字机	陈慧琳	打字机
不得了	陈慧琳	花花宇宙
今生你作伴	陈慧琳	我是阳光的
对你太在乎	陈慧琳	真感觉
心不设防	陈慧琳	Love Kelly 最爱陈慧琳 精选辑
有时寂寞	陈慧琳	Kellylicious
再生花	陈慧琳	最爱的主题曲
她一定很爱你	陈慧琳	Baby Cat
她比我丑	陈慧琳	爱
我不够爱你	陈慧琳	Especial Kelly
大日子	陈慧琳	大日子
再见北极雪	周传雄|陈慧琳	星空下的传说
希望	陈慧琳	Grace & Charm
有福气	陈慧琳	Ask Kelly
蝴蝶泉边 (Live)	黄雅莉	超强音浪 第18期
Shall we talk (Live)	黄雅莉	蒙面唱将猜猜猜 第10期
田园香	黄雅莉	黄雅莉的奇幻秀
给眼泪一点时间	黄雅莉	给眼泪一点时间
我的光	黄雅莉	你好，旧时光 连续剧原声带
曾经 (Live)	黄雅莉	金曲捞 第7期
丑八怪 (Live)	黄雅莉	蒙面唱将猜猜猜 第10期
前任女友	黄雅莉	前任女友
心跳着	黄雅莉	路从今夜白之遇见青春 电视剧原声带
年轮	黄雅莉	年轮
相爱的人都等在那地方	黄雅莉	雅莉不怕
不一定快乐	黄雅莉	雅莉不怕
黄雅莉	黄雅莉	说故事的人总掉眼泪
再见面的时候	黄雅莉	年轮
远在咫尺近在天边	黄雅莉	远在咫尺近在天边
想你笑	黄雅莉	前任女友
小星星	黄雅莉	小星星
喵喵歌 (Live)	黄雅莉	跨年演唱会2012-2013 华语篇2
时空旅人	黄雅莉	说故事的人总掉眼泪
两人世界	黄雅莉	黄雅莉的奇幻秀
一爱难求	徐佳莹	一爱难求
失落沙洲 (Live)	徐佳莹	超强音浪 第32期
身骑白马 (Live)	徐佳莹	超强音浪 跨年特别节目
最初的记忆	徐佳莹	夏至未至 电视剧原声带
突然好想你	徐佳莹	女也 Herstory with Mayday
不醉不会 (Live)	徐佳莹	我是歌手第四季 第3期: 踢馆赛
修炼爱情 (Live)	徐佳莹	我是歌手第四季 第2期: 淘汰赛
我们的十年	徐佳莹	我们的十年
浪费 (Live)	徐佳莹	我是歌手第四季 第10期: 补位赛
不要再孤单	徐佳莹	不要再孤单
莉莉安 (Live)	徐佳莹	我是歌手第四季 第4期: 补位赛
远走高飞 (合唱版)	徐佳莹	Hello 1
我好想你 (Live)	徐佳莹	我是歌手第四季 第5期: 淘汰赛
不为谁而作的歌 (Live)	徐佳莹|林俊杰	我是歌手第四季 歌王之战
湫兮如风	徐佳莹	湫兮如风
大雨将至 (Live)	徐佳莹	江苏卫视919狂欢夜晚会
喜欢你 (Live)	徐佳莹	我是歌手第四季 第6期: 踢馆赛
不痛 (Live)	徐佳莹	我是歌手第四季 第7期: 补位赛
当我找到了你	徐佳莹	当我找到了你
咕叽咕叽 (Live)	徐佳莹	我是歌手第四季 第8期: 淘汰赛
斯琴高丽的伤心	斯琴高丽	斯琴高丽首张同名专辑
犯错	斯琴高丽	爱上你
猜	斯琴高丽	更好
观音手	斯琴高丽	斯琴高丽首张同名专辑
斯琴高丽伤心 (Demo)	斯琴高丽	更好
上上签	斯琴高丽	更好
好想你	斯琴高丽	更好
爱是你给我的伤	斯琴高丽	爱是你给我的伤
爱上你很快乐	斯琴高丽	爱上你
犯错	斯琴高丽	顾式情歌
我也只是个女人	斯琴高丽	斯琴高丽的开心
斯琴高丽的开心	斯琴高丽	斯琴高丽的开心
分手的那天	斯琴高丽	爱上你
猜	斯琴高丽	出口
爱上你	斯琴高丽	爱上你
情不悔	斯琴高丽	我最爱的一首歌
犯错 (DJ原声版)	斯琴高丽	DJ何鹏舞曲精选集（一）
当我傻瓜	斯琴高丽	爱上你
假如爱能重来过	斯琴高丽	假如爱能重来过
情如花	斯琴高丽	情如花
我只在乎你	邓丽君	邓丽君精选2
漫步人生路	邓丽君	邓丽君精选2
甜蜜蜜	邓丽君	甜蜜蜜
小城故事	邓丽君	环球2000超巨星系列 - 邓丽君
在水一方	邓丽君	邓丽君精选1
月亮代表我的心	邓丽君	香港之恋
恰似你的温柔	邓丽君	邓丽君精选1
你怎么说	邓丽君	在水一方
千言万语	邓丽君	Greatest Hits
何日君再来	邓丽君	再见我的爱人 精选8
夜来香	邓丽君	但愿人长久 邓丽君15周年纪念集
但愿人长久	邓丽君	邓丽君精选1
酒醉的探戈	邓丽君	我只在乎你
再见！我的爱人 (国语)	邓丽君	再见！我的爱人
阿里山的姑娘	邓丽君	爱的箴言
北国之春 (Spring in the North)	邓丽君	不了情
北国之春	邓丽君	北国之春
山茶花	邓丽君	假如我是真的
独上西楼	邓丽君	邓丽君精选1
微风细雨	邓丽君	一个小心愿
你怎么舍得我难过	黄品源	男配角的心声
海浪	黄品源	海浪
小薇	黄品源	简单情歌 小薇
那么爱你为什么	黄品源|莫文蔚	狠不下心
狠不下心	黄品源	狠不下心
孤单爱情海	黄品源	爱你!爱你!
我该用什么样的心来对你	黄品源	黄品源抒情精选
永远有多远	黄品源	爱你!爱你!
情人	黄品源	感谢．情人thanks my love
那么爱你为什么	莫文蔚|黄品源	含情莫莫 (全精选辑)
你怎么会这样离开我	黄品源	爱你!爱你!
情非得已 (Live)	黄品源	简单情歌香港演唱会
浪花一朵朵 + 小薇 + 对面的女孩看过来 (Live)	黄品源	快乐天堂 滚石30演唱会
不想说再见	黄品源	寂寞旋律
你怎么舍得我难过(Live)	黄品源	友善的狗9大创作艺人
就算痛的是我	黄品源	双鱼的责任
谁能让时间倒转	黄品源	谁能让时间倒转
永远有多远 (Live)	黄品源	金曲捞 第2期
那么爱你为什么 (Live)	黄品源	围炉音乐会 第22期
你的眼泪	黄品源	男配角的心声
父亲写的散文诗 (时光版)	许飞	父亲写的散文诗
我要的飞翔 (Live)	许飞	乐人·Live：许飞专辑首唱会
如果有个直达天堂的电梯	许飞	如果你想做一些别人做不到的事
寻水的鱼	许飞	许飞
左半边翅膀 (Live)	许飞	乐人·Live：许飞专辑首唱会
不说再见	许飞	不说再见
突然好想你	许飞	许飞的GUITAR自选集
那年夏天 (Live)	许飞	乐人·Live：许飞专辑首唱会
我们终究会牵手旅行	许飞	我们终究会牵手旅行 EP
淡淡的歌 (Live)	许飞	乐人·Live：许飞专辑首唱会
时光遐想	许飞	你好，旧时光 连续剧原声带
我设计一万种方式遇见你	许飞	许飞
慢慢的我	许飞	慢慢的我
他在那里站岗	许飞	他在那里站岗
新兵日记	许飞	新兵日记
梨花又开放	许飞	许飞的GUITAR自选集
我们要走遍所有最浪漫的地方	许飞	许飞
许愿树	许飞	家有公婆
故乡的云	许飞	许飞的GUITAR自选集
在水一方	许飞	许飞的GUITAR自选集
潮湿的心	卓依婷	蜕变1少女的心情故事
爱拼才会赢	卓依婷	闽南语情歌大对唱
萍聚	卓依婷	蜕变1少女的心情故事
东南西北风	卓依婷	蜕变4 婷不了的爱
迟来的爱	卓依婷	蜕变1少女的心情故事
明天会更好	卓依婷	校园青春乐2
捉泥鳅	卓依婷	校园青春乐
心雨	卓依婷	蜕变1少女的心情故事
Hello	卓依婷	卓依婷
谢谢你一直爱着我	卓依婷	卓依婷
爱情一阵风	卓依婷	闽南语情歌大对唱
曾经心疼	卓依婷	蜕变1少女的心情故事
长相依	卓依婷	化蝶
杜十娘	卓依婷	蝴蝶情事
爱江山更爱美人	卓依婷	化蝶
童年	卓依婷	校园青春乐
风中有朵雨做的云	卓依婷	蜕变1少女的心情故事
真的好想你	卓依婷	蜕变2少女的心情故事
梦醒时分	卓依婷	谜 蜕变3
新鸳鸯蝴蝶梦	卓依婷	谜 蜕变3
爱，是一条河流	李泉	爱，是一条河流
Sunny II (Live)	李泉	歌手第二季 第12期
我要我们在一起 (Live)	李泉	歌手第二季 第3期
一生所爱 (Live)	李泉	歌手第二季 第7期
想爱你 (Live)	李泉	歌手第二季 第9期
秋意浓 (Live)	李泉	歌手第二季 第5期
爱的箴言 (Live)	李泉	歌手第二季 第4期
走钢索的人	李泉	走钢索的人
哪怕我很小 (Live)	李泉	歌手第二季 第8期
眼色 (Live)	李泉	歌手第二季 第6期
拥有	李泉	再见忧伤
My Way (Live)	李泉	歌手第二季 第10期
哭了	李泉	走钢索的人
说错 (Live)	李泉	歌手第二季 2018巅峰会
我要我们在一起 (Live)	杨宗纬|李泉	我是歌手第一季 总决赛
Sunny	李泉	Sunny
时间飞了	李泉	岛中央
Endless Love (Live)	李泉|陈洁仪	歌手第二季 歌王之战
老人与海	李泉	天才与尘埃
夜夜夜夜 (Live)	古巨基|李泉	梦想星搭档 第8期
你的眼神	蔡琴	你的眼神
被遗忘的时光	蔡琴	出塞曲
恰似你的温柔	蔡琴	你的眼神
渡口	蔡琴	再爱我一次
张三的歌	蔡琴	惠威试音天碟Ⅱ
把悲伤留给自己	蔡琴	情锁
南屏晚钟	蔡琴	回到未来（国语老歌）
读你	蔡琴	此情可待
往事只能回味 (Live)	蔡琴	不了情 2007经典歌曲香港演唱会
明月千里寄相思	蔡琴	蓝色的梦
明天你是否依然爱我	蔡琴	蔡琴36首经典精选
月满西楼	蔡琴	人生就是戏
绿岛小夜曲	蔡琴	你的眼神
不了情	蔡琴	昨夜之灯
夜来香	蔡琴	人生就是戏
相思河畔	蔡琴	人生就是戏
其实你不懂我的心	蔡琴	金声演奏厅
外婆的澎湖湾	蔡琴	爱像一首歌
情人的眼泪	蔡琴	不了情
月光小夜曲	蔡琴	昨夜之灯
黄昏	周传雄	忘记
冬天的秘密	周传雄	恋人创世纪
寂寞沙洲冷	周传雄	星空下的传说
关不上的窗	周传雄	恋人创世纪
我的心太乱	周传雄	我的心太乱
男人海洋	周传雄	男人.海洋
有没有一首歌会让你想起我	周传雄	我在身边
蓝色土耳其	周传雄	蓝色土耳其
青花	周传雄	蓝色土耳其
记事本	周传雄	忘记
弱水三千	周传雄	蓝色土耳其
出卖	周传雄	忘记
花香	周传雄	Dubbing 情歌教父周传雄1987-2003
告白气球 (Live)	周传雄	蒙面唱将猜猜猜第二季 中秋特辑
末班车	周传雄	忘记
忘记	周传雄	忘记
吉普赛情人	周传雄	小刚的花花世界
樱吹雪	周传雄	时不知归
暖风	周传雄	我的心太乱
伤心酒杯	周传雄	恋人创世纪
让泪化作相思雨	樊桐舟	释放
你是我一生最爱的人	樊桐舟	绝色Ⅱ
最远的你是我最近的爱	樊桐舟	绝色III
语花蝶	樊桐舟	语花蝶
男人的好	樊桐舟	绝色
不让我的眼泪陪我过夜	樊桐舟	绝色
雪花	樊桐舟	试音绝赏 发烧靓声
万水千山总是爱	樊桐舟	万水千山总是爱
擦肩而过	樊桐舟	忘记Ⅱ
分飞	樊桐舟	绝色
为爱伤心为你痛	樊桐舟	再度重相逢
无情的雨无情的你	樊桐舟	再度重相逢
情为何物	樊桐舟	情为何物
别让我一个人醉	樊桐舟	黑鸭子
两只蝴蝶 (英语)	樊桐舟	绝色
朋友别哭	樊桐舟	再度重相逢
曾经最美	樊桐舟	绝色III
一生爱你千百回	樊桐舟	绝色III
寂寞沙洲冷	樊桐舟	绝色Ⅱ
那一夜	樊桐舟	绝色
分飞	徐怀钰	Love
踏浪	徐怀钰	Love
我是女生	徐怀钰	徐怀钰 YUKI 第一张个人专辑
叮咚	徐怀钰	向前冲
向前冲	徐怀钰	向前冲
温习	徐怀钰	徐怀钰 YUKI 第一张个人专辑
水晶	徐怀钰	情义（新歌+精选）光耀全纪录
友情卡片	徐怀钰	U WANT 欲望
怪兽	徐怀钰	向前冲
爱像一场重感冒	徐怀钰	徐怀钰 YUKI 第一张个人专辑
天使	徐怀钰	天使
Tiamo	徐怀钰	滚石香港黄金十年徐怀钰精选
心中的遗憾	徐怀钰	Bad Girl
乱了	徐怀钰	Love
谁不乖	徐怀钰	魔法阿妈之恋爱2世代 电影原声带
誓言	徐怀钰	Love
妙妙妙	徐怀钰	徐怀钰 YUKI 第一张个人专辑
Na Na Na	徐怀钰	Love
大家来恋爱	刘若英|徐怀钰	涩女郎电视剧原声带
等不及	徐怀钰	天使
一剪梅	费玉清	天之大
千里之外	周杰伦|费玉清	依然范特西
南屏晚钟	费玉清	旧曲情怀2
上海滩 (Live)	费玉清	天籁之战第二季 第9期
梦驼铃	费玉清	梦驼铃
昨夜小楼又东风	费玉清	天之大
涛声依旧	费玉清	天之大
一帘幽梦	费玉清	回想曲之情话绵绵
成都 (Live)	费玉清	天籁之战第二季 第4期
新鸳鸯蝴蝶梦	费玉清	晚安曲
在水一方	费玉清	回想曲之情话绵绵
爱的供养 (Live)	费玉清	天籁之战第二季 第8期
真的好想你	费玉清	天之大
大王带我来巡山 (Live)	费玉清	国民美少女 第3期
卷珠帘 (Live)	费玉清	中国好歌曲第一季 总决赛
千里之外 (独唱版)	费玉清	回想曲 青青校树
小城故事	费玉清	何日君再来
青花瓷 (Live)	费玉清	中国新歌声 第7期
多情总为无情伤	费玉清	晚安曲
倾国倾城	费玉清	唱一遍一遍
星星点灯	郑智化	星星点灯
水手	郑智化	私房歌
游戏人间	郑智化	游戏人间
别哭，我最爱的人	郑智化	单身逃亡
三十三块	郑智化	私房歌
你的生日	郑智化	年轻时代
堕落天使	郑智化	堕落天使
年轻时代	郑智化	年轻时代
我这样的男人	郑智化	年轻时代
麻花辫子	郑智化	星星点灯
中产阶级	郑智化	悔过书
面子问题	郑智化	游戏人间
沉默的羔羊	郑智化	落泪的戏子
用我一辈子去忘记	郑智化	堕落天使
单身逃亡	郑智化	单身逃亡
落泪的戏子	郑智化	落泪的戏子
大同世界	郑智化	私房歌
未婚爸爸	郑智化	悔过书
小草	郑智化	游戏人间
别哭我最爱的人	郑智化	金曲重炫-2
如果有来生 (Live)	谭维维	湘江音乐节
为了你	谭维维	为了你
乌兰巴托的夜 (Live)	谭维维	“维所欲为”个人巡回演唱会
华阴老腔一声喊 (Live)	谭维维	2016中央电视台春节联欢晚会
三十岁的女人	谭维维	三十岁的女人
墨梅 (Live)	谭维维	经典咏流传 第11期
缘分一道桥	王力宏|谭维维	A.I. 爱
开门见山 (Live)	谭维维	我是歌手第三季 第7期
夜空中最亮的星 (Live)	谭维维	蒙面唱将猜猜猜第二季 第11期
爱到底	谭维维	爱到底
给你一点颜色 (Live)	谭维维	中国之星 第3期
爱难脱身	谭维维	脱身 电视原声带
一生所爱 (Live)	谭维维	“维所欲为”个人巡回演唱会
要死就一定要死在你手里 (Live)	谭维维	我是歌手 2015巅峰会
灯塔 (Live)	谭维维	四川卫视2017花开天下跨年演唱会
绅士 + 如果有来生 + 我们的爱 (Live)	薛之谦|谭维维	跨界歌王第三季 第1期
谭某某 (Live)	谭维维	湘江音乐节
陌上花开	谭维维	陌上花开
天籁之爱	谭维维	空
Blah Blah Blah	谭维维	夏长
慢慢喜欢你	莫文蔚	我们在中场相遇
忽然之间	莫文蔚	就是 莫文蔚
盛夏的果实	莫文蔚	NO.1新曲精选全记录20首
阴天	莫文蔚	You Can
电台情歌	莫文蔚	做自己
如果没有你	莫文蔚	如果没有你
他不爱我	莫文蔚	做自己
扶摇	莫文蔚	扶摇
半生缘（我们在这里相遇）	莫文蔚	我们在中场相遇
广岛之恋	莫文蔚	做自己
外面的世界	莫文蔚	回蔚
当你老了	莫文蔚	当你老了
一生所爱	卢冠廷|莫文蔚	齐天周大圣之西游双记 电影歌乐游唱版
如初之光	莫文蔚	我们在中场相遇
爱	莫文蔚	[i]
I Do	莫文蔚	我们在中场相遇
爱情	莫文蔚	我要说I Say
不待续	莫文蔚	我们在中场相遇
寂寞的恋人啊	莫文蔚	十二楼的莫文蔚
一念之间	张杰|莫文蔚	中国音乐电视
暗香	沙宝亮	暗香
最初的信仰	沙宝亮	男人好难
男人好难	沙宝亮	男人好难
友情卡片 (Live)	沙宝亮	金曲捞 第6期
野子 (Live)	沙宝亮	江苏卫视“2016幸福聚荔”跨年演唱会
飘	沙宝亮	沙宝亮
女人的选择	沙宝亮	男人好难
往事随风 (Live)	沙宝亮	我是歌手第一季 第10期
秋意浓	沙宝亮	男人好难
你把我灌醉	沙宝亮	男人好难
阆中之恋	姚贝娜|沙宝亮	阆中之恋
爱的人	沙宝亮	我的娜塔莎 电视剧原声带
让每个人都心碎	沙宝亮	男人好难
多瑙河畔	沙宝亮	多瑙河畔
1314	沙宝亮	沙宝亮Ⅲ
其实你不懂我的心	沙宝亮	温暖 影视歌曲精选
爱你在心口难开 (Live)	沙宝亮	[即刻出发]·北京演唱会 Live
Senorita	沙宝亮	沙宝亮
送别 (Live)	沙宝亮	经典咏流传 第3期
袖手旁观 (Live)	沙宝亮	蒙面唱将猜猜猜 第11期
再见	张震岳	再见
爱的初体验	张震岳	这个下午很无聊
思念是一种病	张震岳|蔡健雅	OK
爱我别走	张震岳	秘密基地
差不多先生 (Live)	张震岳	中国有嘻哈 第5期
小宇	张震岳	OK
自由	张震岳	秘密基地
就让这首歌	张震岳	OK
路口	张震岳	OK
凡人歌 (Live)	张震岳	中国有嘻哈 第9期
不要说爱我	张震岳	阿岳正传
两手空空	张震岳	两手空空
思念是一种病 (Live)	张震岳	破浪演唱会
很难	张震岳	OK
分手吧	张震岳	秘密基地
酒干倘卖无 (Live)	张震岳	中国有嘻哈 第12期
嗨嗨人生	张震岳	我想要的感觉
我家门前有大海	张震岳	我是海雅谷慕
抱着你	张震岳	我是海雅谷慕
我会想念你	张震岳	阿岳正传
快乐崇拜	潘玮柏|张韶涵	WuHa
我想更懂你	潘玮柏	反转地球
不得不爱	潘玮柏	高手
Coming Home	潘玮柏	illi异类
反转地球	潘玮柏	反转地球
Tell Me	潘玮柏	壁虎漫步
爱上未来的你	潘玮柏	我的麦克风
亲爱的	潘玮柏	零零七
双人舞	潘玮柏	零零七
我的麦克风	潘玮柏	我的麦克风
壁虎漫步	潘玮柏	壁虎漫步
路太弯	潘玮柏	玩酷
我对天空说	潘玮柏	我对天空说
稀罕没理由	潘玮柏	illi异类
U U U	潘玮柏	808
转机 (国语)	潘玮柏	Will's 未来式
One Love (Live)	潘玮柏	中国有嘻哈 第12期
高手	潘玮柏	高手
听妈妈的话 (Live)	周杰伦|潘玮柏|张学友	2007世界巡回演唱会
24个比利	潘玮柏	24个比利
你要的全拿走	胡彦斌	覅忒好
爱不得 恨不得 舍不得	胡彦斌	爱不得 恨不得 舍不得
月光	胡彦斌	音乐斌潮
还魂门	胡彦斌	还魂门
为你我受冷风吹	胡彦斌	太歌
红颜	胡彦斌	音乐斌潮
决别诗	胡彦斌	男人歌 全胜铂金版
男人KTV	胡彦斌	男人歌 全胜铂金版
在一起	胡彦斌	大一号
蝴蝶	胡彦斌	音乐密码
慢慢 (Live)	胡彦斌	梦想的声音第二季 第2期
快意江湖	胡彦斌	快意江湖
包袱	胡彦斌	文武双全
山丘 (Live)	胡彦斌	我是歌手第三季 第1期
潇湘雨	胡彦斌	音乐斌潮
当爱已成往事	胡彦斌	太歌
味道 (Live)	胡彦斌	我是歌手第三季 第5期
江湖再见	胡彦斌	大一号
愿望	胡彦斌	音乐密码
Waiting For You	胡彦斌	MuSiC混合体
陪我看日出	蔡淳佳	日出
等一个晴天	蔡淳佳	淳佳精选17首
依恋	蔡淳佳	蔡淳佳 EP
庆幸有你爱我	蔡淳佳	庆幸拥有蔡淳佳
对不起我爱你 (中文版)	蔡淳佳	淳剧佳曲 电视剧原声带
眼里眉间	蔡淳佳	庆幸拥有蔡淳佳
回到最初	蔡淳佳	回到最初
要幸福啊	蔡淳佳	回到最初
Yesterday	蔡淳佳	庆幸拥有蔡淳佳
南屏晚钟	蔡淳佳	有一天我会
前座后座	蔡淳佳	回到最初
风铃	蔡淳佳	淳佳精选17首
玻璃	蔡淳佳	放手爱 电影原声带
隐形纪念	蔡淳佳	回到最初
爱如潮水	蔡淳佳	蔡淳佳JOI
回家的路	蔡淳佳	回到最初
左右为难	蔡淳佳	等一个晴天 (新歌+精选)
檐前雨	蔡淳佳	回到最初
有一天我会	蔡淳佳	有一天我会
有心人 有情人	蔡淳佳	淳佳精选17首
说句心里话	阎维文	世纪歌典1978-2000(5)
小白杨	阎维文	世纪歌典Vol.12 1978 - 2000 (3)
想家的时候	阎维文	世纪歌典13:1978-2000 Vol.4
母亲	阎维文	想家的时候
人间第一情	阎维文	小白杨
红星照我去战斗	阎维文	克拉玛依之歌
强军战歌	阎维文	阎维文单曲集
一二三四歌	阎维文	祖国万岁
十五的月亮	阎维文	克拉玛依之歌
乌苏里船歌	阎维文	克拉玛依之歌
祝妈妈长寿	阎维文	想家的时候
敖包相会	张也|阎维文	老情歌
打靶归来	阎维文	空
我爱五指山，我爱万泉河	阎维文	红色情歌
送别	阎维文	想家的时候
篱笆墙的影子	阎维文	黑土情歌
军人本色	阎维文	阎维文演唱歌曲精选
什么也不说	阎维文	空
人说山西好风光	阎维文	黄土情歌
夫妻情	阎维文	阎维文演唱歌曲精选
逝去的爱	欧阳菲菲	追忆
感恩的心	欧阳菲菲	出境入境
吻到心伤透	欧阳菲菲	出境入境
热情的沙漠	欧阳菲菲	追忆
爱的路上我和你	欧阳菲菲	出境入境
的士高皇后	欧阳菲菲	追忆
出境入境	欧阳菲菲	出境入境
不是因为寂寞才想你	欧阳菲菲	单曲 - 不是因为寂寞才想你
雨中徘徊	欧阳菲菲	追忆
ラヴ·イズ·オーヴァー (Love is Over)	欧阳菲菲	ベストアルバム
寂寞的高跟鞋	欧阳菲菲	追忆
心声	欧阳菲菲	向往
今夜我仍在想你	欧阳菲菲	追忆
追忆	欧阳菲菲	追忆
尽在不言中	欧阳菲菲	欧阳菲菲旷世精选
你想爱谁就爱谁	欧阳菲菲	林夕音乐词典
不能没有你	欧阳菲菲	欧阳菲菲畅销金曲
火鸟	欧阳菲菲	欧阳菲菲旷世精选
再见午夜	欧阳菲菲	欧阳菲菲畅销金曲
不要离开我	欧阳菲菲	追忆
有没有人曾告诉你 (Live)	陈楚生	超强音浪 第20期
有没有人告诉你 (Live)	陈楚生	"璀璨之夜"2018江西卫视跨年演唱会
风起时，想你	陈楚生	影之传说
瘾	陈楚生	瘾
经过	陈楚生|何洁	消失的子弹 电影原声带
那个远方	陈楚生	旋风少女 电视剧原声带
一场游戏一场梦 (Live)	陈楚生	蒙面唱将猜猜猜第二季 第3期
我知道你离我不远	陈楚生	我知道你离我不远
山楂花	陈楚生	山楂树之恋 电影原声带
姑娘	陈楚生	快乐男声陈楚生歌曲
渺小 (Live)	陈楚生	蒙面唱将猜猜猜第二季 中秋特辑
一个人的冬天	陈楚生	一个人的冬天
倾国倾城	陈楚生|齐秦	空
思念一个荒废的名字	陈楚生	瘾
相忘于江湖	陈楚生	狄仁杰 OST
不如怀念	陈楚生	五鼠闹东京 电视剧原声带
岁月神偷 (Live)	陈楚生	蒙面唱将猜猜猜第二季 第4期
经过 (独唱版)	陈楚生	经过
一个人唱情歌	陈楚生	冬去春来
夜夜夜夜 (Live)	陈楚生	金钟奖中国音超 第1期
讲不出再见	谭咏麟	梦幻的笑容
一生中最爱	谭咏麟	神话1991
朋友	谭咏麟	暴风女神Lorelei
再见亦是泪	谭咏麟	爱的盛筵（粤语纪念版）
爱在深秋	谭咏麟	环球一双情缘系列 - 谭咏麟
爱多一次痛多一次	谭咏麟	环球2000超巨星系列 - 谭咏麟
披着羊皮的狼 (国语)	谭咏麟	天地
难舍难分	谭咏麟	难舍难分
一生何求	谭咏麟	我们一起唱过的歌
水中花 (粤语)	谭咏麟	拥抱
情缘巴士站	谭咏麟	伴我飞翔
千千阙歌	谭咏麟	我们一起走过的日子
让一切随风	谭咏麟	我们一起唱过的歌
爱情陷阱	谭咏麟	爱情陷阱
半梦半醒	谭咏麟	环球DSD视听之王 - 谭咏麟
明天你是否依然爱我	谭咏麟|关淑怡	神话1991
捕风的汉子	谭咏麟	爱的根源
也曾相识	谭咏麟	世外桃源
雨夜的浪漫	谭咏麟	爱情陷阱
爱与痛的边缘	谭咏麟	左麟右李
一生所爱	卢冠廷|莫文蔚	齐天周大圣之西游双记 电影歌乐游唱版
一生所爱	卢冠廷	Beyond Imagination (Deluxe)
如风往事	李宗盛|卢冠廷	我们就是这样 2×Man Life
但愿人长久	卢冠廷	EMI至爱经典系列 - 卢冠廷
再回首	李宗盛|卢冠廷	我们就是这样 2×Man Life
一生所爱 (Live)	卢冠廷	卢冠廷 2050 演唱会
浪子心声	卢冠廷	Beyond Imagination Too
陪着你走	卢冠廷	陪着你走
凭着爱 + 再回首 (Live)	卢冠廷|李宗盛	卢冠廷 2050 演唱会
世事何曾是绝对	卢冠廷	EMI至爱经典系列 - 卢冠廷
一生所爱 (Live)	卢冠廷	Beyond Imagination Concert Live 2016
凭著爱	卢冠廷	卢冠廷 Masterpieces Since 1982
赌神	卢冠廷	赌神 电影原声
陪着你走	卢冠廷	Denon Mastersonic 卢冠廷 Vol. 1
风继续吹 (Live)	卢冠廷	Beyond Imagination Concert Live 2016
一生所爱	卢冠廷	空
我是一只小小鸟 (Live)	卢冠廷|李宗盛	卢冠廷 2050 演唱会
如风往事 (Live)	卢冠廷|李宗盛	卢冠廷 2050 演唱会
大话西游	卢冠廷	齐天周大圣之西游双记
天籁	卢冠廷	EMI至爱经典系列 - 卢冠廷
A Little Love	冯曦妤	A Little Love
Proud Of You	冯曦妤	A Little Love
我在那一角落患过伤风	冯曦妤	背景音乐之旅.(CD1)
避风港 (国语)	冯曦妤	A Little Love
The Glorious Death	冯曦妤	A Little Love
Shining Friends	冯曦妤	A Little Love
幸运儿	冯曦妤	A Little Love
再见警察	冯曦妤	如果...阳光．雨（新曲+精选）
Forever Friends	冯曦妤	A Little Love
如果…阳光	冯曦妤	如果...阳光．雨（新曲+精选）
I Miss You	陈柏宇|冯曦妤	I Miss You
不做你的情人 (国语)	冯曦妤	A Little Love
A Little Love	冯曦妤	如果...阳光．雨（新曲+精选）
A Wonderful Day	冯曦妤	A Little Love
阳光．雨	冯曦妤	A Little Love
U Are My Everything	冯曦妤	Sweet Melody
小伤口	冯曦妤	A Little Love
Just Be Yourself	冯曦妤	Just Be Yourself
天生不对	冯曦妤	Sweet Melody
I Love Sunshine	冯曦妤	A Little Love
微不足道的小事是我还爱着你	张磊	忽而今夏 电视剧珍爱原声大碟
虎口脱险 (Live)	张磊	“张磊的漂泊日记”2016北京演唱会
南山南 (Live)	张磊	全球中文音乐榜上榜
异乡人 (Live)	张磊	“张磊的漂泊日记”2016北京演唱会
暖人	张磊	暖人
梦一场	张磊	梦一场
人生是一次热血的流浪	张磊	人生是一次热血的流浪
因为一个人	张磊	因为一个人
旅行 (Live)	张磊	“张磊的漂泊日记”2016北京演唱会
一念天堂	张磊	一念天堂
路远	张磊	好先生 电视剧原声带
幸福一家人	张磊	幸福一家人
相爱恨晚	张磊	柠檬初上 电视剧原声带
后来你好吗	张磊	张磊的
那么骄傲 (Live)	张磊	蒙面唱将猜猜猜 第9期
远方	张磊	远方
一次就好 (Live)	张磊	蒙面唱将猜猜猜 第9期
切歌之王	张磊	张磊的
文艺少年	张磊	文艺少年
旅行者	张磊	张磊的
独角戏	许茹芸	如果云知道
如果云知道	许茹芸	如果云知道
泪海	许茹芸	泪海
不爱我放了我	许茹芸	我依然爱你
突然想爱你	许茹芸	如果云知道
美梦成真	许茹芸	你是最爱
好听	许茹芸	好听
我依然爱你	许茹芸	我依然爱你
你的眼睛	熊天平|许茹芸	爱情多恼河
我有一帘幽梦	许茹芸	一帘幽梦 电视原声带
为你我受冷风吹 (Live)	许茹芸	谁是大歌神 第7期
一帘幽梦	许茹芸	一帘幽梦 电视原声带
独上西楼	许茹芸	醇经典
日光机场	许茹芸	日光机场
梅花 (Live)	许茹芸	经典咏流传 第8期
我绝对不说我爱你	许茹芸	北纬66度
你怎么舍得伤害我	梁咏琪|许茹芸	你怎么舍得伤害我
在水一方	许茹芸	流金十载许茹芸全纪录
男人女人	许茹芸	北纬66度
爱情电影	许茹芸|熊天平	茹此精彩十三首
你啊你啊	魏如萱	末路狂花
香格里拉 (Live)	魏如萱	旅行团＆魏如萱·专场
Don't Cry Don't Cry	魏如萱	Don't Cry Don't Cry
晚安晚安 (Live)	魏如萱	旅行团＆魏如萱·专场
星期三或礼拜三	魏如萱	星期三或礼拜三
还是要相信爱情啊混蛋们	魏如萱	还是要相信爱情啊混蛋们
我爸的笔 (Live)	魏如萱	旅行团＆魏如萱·专场
小鱼	魏如萱	末路狂花
末路狂花	魏如萱	末路狂花
末路狂花 (Live)	魏如萱	中国新歌声第二季 第11期
好吗好吗	魏如萱	还是要相信爱情啊混蛋们
我们	魏如萱	爱（Love） 电影原声带
女人经痛时	魏如萱	甜蜜生活
买你 (Live)	魏如萱	旅行团＆魏如萱·专场
Downtown Cafe	魏如萱	甜蜜生活
爱的季节	魏如萱	回到爱开始的地方 电影原声带
一起去旅行 (Demo)	魏如萱	生活练习曲
房间	魏如萱	甜蜜生活
世界末日的某个角落	魏如萱	甜蜜生活
一万个不回头的方法	魏如萱	末路狂花
我喜欢上你时的内心活动	陈绮贞	我喜欢上你时的内心活动
旅行的意义	陈绮贞	旅行的意义
还是会寂寞	陈绮贞	还是会寂寞
私奔到月球	陈绮贞	离开地球表面 Jump!
告诉我	陈绮贞	还是会寂寞
天天想你 (Live)	陈绮贞	民歌四十 再唱一段思想起——深圳场
太聪明	陈绮贞	吉他手 陈绮贞 groupies
九份的咖啡店	陈绮贞	陈绮贞 精选 1998-2005
小步舞曲	陈绮贞	吉他手 陈绮贞 groupies
讨厌喜欢你	陈绮贞	空
就算全世界与我为敌	陈绮贞	吉他手 陈绮贞 groupies
微凉的你	陈绮贞	让我想一想
我的骄傲无可救药	陈绮贞	还是会寂寞
我亲爱的偏执狂	陈绮贞	吉他手 陈绮贞 groupies
After 17 (Live)	陈绮贞	空
小尘埃	陈绮贞	吉他手 陈绮贞 groupies
送别	陈绮贞	快乐の夏天 EP
躺在你的衣柜	陈绮贞	吉他手 陈绮贞 groupies
情歌	陈绮贞	让我想一想
鱼 (Live)		梦想的声音 第10期
蝴蝶泉边 (Live)	牛欣欣	中国新声代第二季 第11期
灯塔 (Live)	牛欣欣	中国新声代第二季 第1期
还能孩子多久 (Live)	牛欣欣	中国新声代第二季 第7期
梦.计划	牛欣欣	梦.计划
莫斯科没有眼泪	牛欣欣	空
舞公主	牛欣欣	舞公主
梦的主场	牛欣欣	梦的主场
没有什么不同	牛欣欣	空
红色竹蜻蜓	牛欣欣	红色竹蜻蜓
下一秒	牛欣欣	空
我的未来式 (Live)	牛欣欣	中国新声代第二季 第3期
有梦的天空	牛欣欣	有梦的天空
吃葡萄不吐葡萄皮	牛欣欣	百变小公主
谁说女子不如男 (Live)	牛欣欣	中国新声代第二季 第10期
魔幻水晶	牛欣欣	百变小公主
See you later	牛欣欣	舞公主
天使在唱歌	牛欣欣	百变小公主
在地球的最后一天	牛欣欣	在地球的最后一天
重整河山待后生 (Live)	牛欣欣	中国新声代第二季 第4期
快乐宝贝 (Live)	牛欣欣	空
千千阙歌	陈慧娴	永远是你的朋友
人生何处不相逢	陈慧娴	秋色
飘雪	陈慧娴	归来吧
月半小夜曲 (Live)	陈慧娴|李克勤	Priscilla-ism Live 2016
逝去的诺言	陈慧娴	少女杂志
傻女	陈慧娴	Evolve
归来吧	陈慧娴	环球2000超巨星系列 - 陈慧娴
孤单背影	陈慧娴	宝丽金黄金时代精品典藏VOL3
夜机	陈慧娴	永远是你的朋友
让一切随风	陈慧娴	By Heart
红茶馆	陈慧娴	归来吧
傻女	陈慧娴	娴情
月半小夜曲 (Live)	陈慧娴	活出生命Ⅱ演唱会
你怎么舍得我难过 (Live)	陈慧娴	蒙面唱将猜猜猜第二季 第10期
跳舞街	陈慧娴	真经典 - 陈慧娴
月亮	陈慧娴	归来吧
人生何处不相逢	陈慧娴	环球一双情缘系列 - 陈慧娴
玻璃窗的爱	陈慧娴	环球一双情缘系列 - 陈慧娴
孤单背影	陈慧娴	归来吧
多少柔情多少梦	陈慧娴	环球2000超巨星系列 - 陈慧娴
再回首	姜育恒	多年以后・再回首
别让我一个人醉	姜育恒	别让我一个人醉
跟往事干杯	姜育恒	跟往事干杯
驿动的心	姜育恒	驿动的心
女人的选择	姜育恒	女人的选择-韩国世纪精选Ⅰ
梅花三弄	姜育恒	别让我一个人醉
多年以后	姜育恒	多年以后・再回首
爱我，你怕了吗	姜育恒|李翊君	爱我你怕了吗？
情难枕	姜育恒	两个永恒 唱作俱佳辑
其实我真的很在乎	姜育恒	其实我真的很在乎
往事只能回味	姜育恒	姜育恒的刘家昌之歌2·往事只能回味
像我这样的人	姜育恒	跟往事干杯
从不后悔爱上你	姜育恒	梅花三弄 Ⅱ 鬼丈夫 电视剧原声带
一帘幽梦	姜育恒	姜育恒的刘家昌之歌2·往事只能回味
一世情缘	姜育恒	一世情缘
哭过 笑过 爱过	姜育恒	痛快的歌
我是个很容易掏心的人	姜育恒	一世情缘
在雨中	姜育恒	姜育恒的刘家昌之歌2·往事只能回味
爱我，你怕了吗 (独唱版)	姜育恒	爱我你怕了吗？
烟火	姜育恒	两个永恒 唱作俱佳辑
谁	谢雨欣	谢雨欣精选
第三天	谢雨欣	爱是怎样炼成的
等你爱我	谢雨欣	谢雨欣精选
天仙子	谢雨欣	欣·成就 (新歌+精选)
将爱情进行到底	谢雨欣	谢雨欣精选
老公老公我爱你	谢雨欣	单曲 - 老公老公我爱你
仰望	谢雨欣	欣天地
步步高	谢雨欣	新世纪爱情宣言
爱是怎样炼成的	谢雨欣	爱是怎样炼成的
生命如歌	谢雨欣	空
穿裙子的季节	谢雨欣	步步高
遥望	谢雨欣	谢雨欣精选
新年快乐	谢雨欣	新世纪爱情宣言
再见的人终会再见面	谢雨欣	拯救爱情
伤了心	谢雨欣	步步高
天上的云我的心	谢雨欣	 
谁 (铃声)	谢雨欣	
花街	谢雨欣	谢雨欣精选
雨花	谢雨欣	步步高
爱到永远 (TV Version)	谢雨欣	空
靠近一点点	梁心颐	下雨天
珊瑚海	周杰伦|梁心颐	十一月的萧邦
不敢哭	梁心颐	给爱丽丝的奇迹 电视剧原声带
不遇见	梁心颐	小时代 音乐剧原声带
小树	梁心颐	HELLO 梁心颐
我不再怕	梁心颐	HELLO 梁心颐
Darling	梁心颐	自由灵魂
蛇舞	周杰伦|梁心颐	魔杰座
碎片	梁心颐	自由灵魂
当秋天遇上秋天	梁心颐	HELLO 梁心颐
比较大的大提琴	周杰伦|梁心颐	十二新作
因为你	梁心颐	HELLO 梁心颐
我没有	梁心颐	给爱丽丝的奇迹 电视剧原声带
滴答	梁心颐	滴答
You Are My Sunshine	梁心颐	第一次 电影原声带
梦织花园	梁心颐	给爱丽丝的奇迹 电视剧原声带
Everything	梁心颐	单曲 - Everything
胡椒与盐	梁心颐	HELLO 梁心颐
不为谁而作的怀念小情歌 (MV版)	梁心颐	 
Gentleman	梁心颐	自由灵魂
味道	辛晓琪	味道
领悟	辛晓琪	领悟
俩俩相忘	辛晓琪	领悟
女人何苦为难女人	辛晓琪	女人何苦为难女人
深情相拥	张国荣|辛晓琪	宠爱
亲爱的小孩 (Live)	辛晓琪	我是歌手第一季 第9期
深情难了	辛晓琪	领悟
走过	辛晓琪	味道
迷途	辛晓琪	怎么?
空窗	辛晓琪	爱的回答
至少还有你 (Live)	辛晓琪	我是歌手第一季 第8期
当爱已成往事 (Live)	辛晓琪|周华健	我是歌手第一季 总决赛
我也会爱上别人的	辛晓琪	我也会爱上别人的 30首恋曲极选
别问旧伤口	辛晓琪	领悟
原来的我 (Live)	辛晓琪	我是歌手第一季 第10期
领悟 (Live)	辛晓琪	我想和你唱 第10期
相信爱情	辛晓琪	相信爱情
承认	辛晓琪	每个女人
始终只爱你	李宗盛|辛晓琪	作品李宗盛
眉来眼去	张国荣|辛晓琪	宠爱
请不要对我说sorry	何洁	敢爱
小永远	何洁	短暂的爱情
越伤越爱	何洁	想要回到 何洁
你是我的风景	何洁	想要回到 何洁
亲爱的游戏	何洁	亲爱的游戏
经过	陈楚生|何洁	消失的子弹 电影原声带
有没有 (Live)	薛之谦|何洁	金曲捞 第5期
不可能的人	何洁	不可能的人
身不由己	何洁	杉杉来了 电视剧原声带
希望	何洁	发光体
我只剩下自己 (Live)	何洁	金曲捞 第8期
是不是爱情	何洁	短暂的爱情
好想你	何洁	青春最好时 电视剧原声带
小情书	何洁	小情书 电影原声带
我多么怀念	何洁	短暂的爱情
请别再爱我	何洁	发光体
双倍心跳	何洁	空
燃烧吧青春	何洁	旋风少女 电视剧原声带
断执念	何洁	断执念
我们结婚吧	何洁	我们结婚吧
偏爱	张芸京	破天荒
春泥	张芸京	我要我们情人结
情人结	张芸京	我要我们情人结
破天荒	张芸京	破天荒
留心 (Live)	张芸京	金曲捞 第4期
青花 (Live)	张芸京	金曲捞 第6期
黑裙子	张芸京	破天荒
我不爱你了	张芸京	相反的我
相反的我	张芸京	相反的我
不再联络	张芸京	相反的我
我没有疯	张芸京	小女孩
让我照顾你	张芸京	破天荒
怎么开始忘了	张芸京	怎么开始忘了
爱情选项	张芸京	相反的我
痛也爱你	张芸京	小女孩
你是唯一	张芸京	相反的我
一天一夜	张芸京	爱别离 电影原声带
青花 (Live)	周传雄|张芸京	金曲捞 第6期
坏了	张芸京	相反的我
留心 (Live)	张芸京	金曲捞 第4期
答案	杨坤	今夜二十岁
空城	杨坤	杨坤 同名专辑
无所谓	杨坤	无所谓
路灯下的小姑娘	杨坤	DISCO
牧马人	杨坤	牧马人
我没你想的那么坚强	杨坤	今夜二十岁
那一天	杨坤	那一天
真的很在乎	杨坤	真的很在乎
穷浪漫	杨坤	牧马人
远走高飞 (Live)	杨坤	天籁之战第二季 第4期
月亮可以代表我的心	杨坤	那一天
站台2010	杨坤	DISCO
要死就一定要死在你手里	杨坤	今夜二十岁
里约热内卢	杨坤	无所谓
直到世界尽头 (Live)	杨坤	天籁之战第二季 第8期
画心 (Live)	杨坤	天籁之战第二季 第3期
今夜二十岁	杨坤	今夜二十岁
我比从前更寂寞	杨坤	2008
两个人的世界	杨坤	无所谓
那么美	杨坤	无所谓
我可以	蔡旻佑	19
你看不到的天空	蔡旻佑	寂寞，好了
寂寞，好了	蔡旻佑	寂寞，好了
我想要说	蔡旻佑	19
好不好	蔡旻佑	原来是美男 电视原声带
怎么爱你都不够	蔡旻佑	超级右脑
我想我可以	蔡旻佑	我想我可以
小乖乖	蔡旻佑	寂寞，好了
翻不完的夏天	蔡旻佑	19
谁知道	蔡旻佑	超级右脑
最安静的话	蔡旻佑	原来是美男 电视原声带
发光的简讯	蔡旻佑	寂寞，好了
假男友	蔡旻佑	我和我的布拉姆斯
2人	蔡旻佑	搜寻蔡旻佑
最烂的我们	蔡旻佑	我和我的布拉姆斯
走	蔡旻佑	寂寞，好了
约定	蔡旻佑	原来是美男 电视原声带
Stay with Me	蔡旻佑	搜寻蔡旻佑
我的宝贝	蔡旻佑	寂寞，好了
热气球	蔡旻佑	19
后来	刘若英	我等你
原来你也在这里	刘若英	我的失败与伟大 2nd Version
当爱在靠近	刘若英	Love & the City
成全	刘若英	年华
为爱痴狂	刘若英	少女小渔刘若英的美丽与哀愁
很爱很爱你	刘若英	很爱很爱你
一辈子的孤单	刘若英	Love & the City
我们没有在一起	刘若英	在一起
亲爱的路人	刘若英	亲爱的路人
听说	刘若英	Rene
分开旅行	刘若英|黄立行	K歌情人派对
十年 (Live)	刘若英	脱掉高跟鞋世界巡回演唱会
幸福不是情歌	刘若英	亲爱的路人
我曾爱过一个男孩	刘若英	年华
幸福就是	刘若英	亲爱的路人
同桌的你	刘若英	在一起
把悲伤留给自己 (Live)	刘若英	单身日志Live演唱会
知道不知道	刘若英	Rene
很爱很爱你 (Live)	刘若英	快乐天堂 滚石30演唱会
经过	刘若英	爱情限量版
我们的歌	王力宏	改变自己
大城小爱	王力宏	盖世英雄
你不知道的事	王力宏	十八般武艺
改变自己	王力宏	改变自己
依然爱你	王力宏	火力全开
心跳	王力宏	心·跳
唯一 (国语)	王力宏	Evolution 音乐进化论
春雨里洗过的太阳	王力宏	心·跳
好心分手	王力宏|卢巧音	力宏二十 20周年唯一精选
爱的就是你 (浪漫版)	王力宏	唯一
另一个天堂	王力宏|张靓颖	心·跳
南京，南京	王力宏	南京，南京
花田错	王力宏	盖世英雄
你是我心内的一首歌	王力宏	改变自己
Can You Feel My World	王力宏	不可思议
需要人陪	王力宏	十八般武艺
心中的日月	王力宏	心中的日月
落叶归根	王力宏	改变自己
Kiss Goodbye	王力宏	盖世英雄
美	王力宏	十八般武艺
天亮了	韩红	醒了
天路	韩红	冰雪莲
青藏高原	韩红	醒了
那片海	韩红	醒了
九儿	韩红	红高粱 电视剧原声带
美丽的神话	孙楠|韩红	忘不了你
绒花	韩红	红
一个人	韩红	我爱故我在
魔鬼中的天使 (Live)	韩红	我想和你唱第三季 第7期
映山红	韩红	红歌②
家乡	韩红	雪域光芒
飞云之下	韩红|林俊杰	飞云之下
梨花又开放 (Live)	韩红	我是歌手第三季 第2期
往事随风 (Live)	韩红	我是歌手第三季 第3期
天地 (Live)	韩红	我想和你唱第三季 第9期
回到拉萨 (Live)	韩红	我是歌手第三季 第7期
天之大	韩红	天之大
橄榄树 (Live)	韩红	我是歌手第三季 第8期
雁南飞	韩红	红歌②
飞行时刻	韩红	飞行时刻
无人岛	周笔畅	重命名
最美的期待	周笔畅	最美的期待
岁月神偷	周笔畅	岁月神偷
谁动了我的琴弦	周笔畅	谁动了我的琴弦
笔记 (Live)	周笔畅	跨年演唱会2012-2013 华语篇2
我选择喜欢你	周笔畅	蜀山战纪 电视剧原声带
对嘴	周笔畅	黑·择·明
注定	周笔畅	注定
若不是那次夜空	周笔畅	若不是那次夜空
用尽我的一切奔向你	周笔畅	电影《闪光少女》OST概念音乐计划
解脱	周笔畅	空
大家一起喜羊羊 (国语)	周笔畅	喜羊羊与灰太狼之虎虎生威 动画电影原声带
说散就散 (Live)	周笔畅	湖南卫视2017-2018跨年演唱会
With You	周笔畅	With You
Fascination	周笔畅	Not Typical
一周年	周笔畅	NOW
密友	周笔畅	Unlock
片羽时光	周笔畅	片羽时光
别忘了	周笔畅	小时代3：刺金时代 电影原声带
不痛	周笔畅	1st EP
七分钟好女孩 七分钟坏女孩	周笔畅	Not Typical
幸福出发	钟欣潼	幸福出发
你不会懂	钟欣潼	你不会懂
完整爱	钟欣潼|张韶涵	完整爱
你看得见吗	钟欣潼	桐话妍语
放低过去	钟欣潼	Move On...
桐花	钟欣潼	桐花
全部都给你	钟欣潼	寂寞来了怎么办
在一起	钟欣潼|胡彦斌	桐花
最美好的未来	钟欣潼	完整爱
星星的眼泪	钟欣潼	完整爱
你会幸福的	钟欣潼	3650
一生一世	钟欣潼	Move On...
非爱不可	钟欣潼	影视旗舰店 影视新歌 + 精选
一辈子	钟欣潼	一辈子
把悲伤留给自己	钟欣潼	把悲伤留给自己
心多	钟欣潼	人人弹起
天后站出发	钟欣潼	人人弹起
惯性冬眠	钟欣潼	桐花
放低过去 (铃声)	钟欣潼	
最近比较烦	容祖儿|钟欣潼	I'm a Lucky Girl
最熟悉的陌生人	萧亚轩	萧亚轩 同名专辑
突然想起你	萧亚轩	萧亚轩 同名专辑
类似爱情	萧亚轩	三面夏娃
爱的主打歌	萧亚轩	爱的主打歌·吻
错的人	萧亚轩	潇洒小姐
一个人的精彩	萧亚轩	红蔷薇
表白	萧亚轩	1087
遗失的心跳	萧亚轩	我爱我
潇洒小姐	萧亚轩	潇洒小姐
他和她的故事	萧亚轩	爱的主打歌·吻
闪闪惹人爱	萧亚轩	钻石糖
吻	萧亚轩	爱的主打歌·吻
后来的我们	萧亚轩	1087
U Make Me Wanna	萧亚轩	爱的主打歌·吻
钻石糖	萧亚轩	钻石糖
倒数	萧亚轩	钻石糖
冲动	萧亚轩	三面夏娃
敢伤	萧亚轩	不解释亲吻
我爱你那么多	萧亚轩	明天
Cappuccino	萧亚轩	萧亚轩 同名专辑
为你我受冷风吹	林忆莲	Love,Sandy
至少还有你	林忆莲	林忆莲's
伤痕	林忆莲	Love,Sandy
不必在乎我是谁	林忆莲	不必在乎我是谁
当爱已成往事	林忆莲|李宗盛	不必在乎我是谁
爱上一个不回家的人	林忆莲	爱上一个不回家的人
听说爱情回来过	林忆莲	Love,Sandy
夜太黑	林忆莲	夜太黑
词不达意	林忆莲	呼吸
领悟 (Live)	林忆莲	回忆莲莲
我最亲爱的 (Live)	林忆莲	歌手 第4期
远走高飞	林忆莲	2001 莲
失踪	林忆莲	林忆莲's
蓝莲花 (Live)	林忆莲	歌手 第7期
铿锵玫瑰	林忆莲	铿锵玫瑰
海阔天空 (Live)	林忆莲	Sandy Lam Concert MMXI
当爱已成往事	李宗盛|林忆莲	霸王别姬
小情歌 (Live)	林忆莲	歌手 2017巅峰会
我好想你 (Live)	林忆莲	梦想的声音第二季 第11期
邂逅	林忆莲	忆莲
情人	杜德伟	99情人
无心伤害	杜德伟	发现爱(香港版)
跟着我一辈子	杜德伟	跟着我一辈子
把你宠坏	杜德伟	99情人
不走	杜德伟	不走完美
脱掉	杜德伟	脱掉
钟爱一生	杜德伟	My Love
嫁给我	杜德伟	杜德伟独领风骚20年新歌精选
把你藏起来	杜德伟	99情人
天真	杜德伟	天真
忘情号	杜德伟	忘情号
黑色契约	杜德伟	原来我爱你那么多(新歌+精选)
彩虹	杜德伟	I Believe
信自己	杜德伟|叶倩文	让自己快乐
制造浪漫 (Live)	杜德伟	蒙面唱将猜猜猜第二季 第5期
原来我Love You So Much	杜德伟	原来我爱你那么多(新歌+精选)
拯救地球	杜德伟	狂风
真的想你	杜德伟	昨日·唯一·更多
你在我的爱情里	杜德伟	你在我的爱情里
想着你的感觉	杜德伟	My Love
我最亲爱的	张惠妹	你在看我吗
如果你也听说	张惠妹	Star
我可以抱你吗 (并四版)	张惠妹	空
连名带姓	张惠妹	偷故事的人
记得	张惠妹	真实
听海 (剧场版)	张惠妹	空
趁早 (Live)	张惠妹	阿密特 首次世界巡回演唱会
最爱的人伤我最深	张惠妹|张雨生	两伊战争
人质	张惠妹	我要快乐？
偷故事的人	张惠妹	偷故事的人
我要快乐？	张惠妹	我要快乐？
好胆你就来	张惠妹	阿密特
原来你什么都不要 (Live)	张惠妹	精彩音乐汇
站在高岗上 (Live)	张惠妹	AMeiZING Live 世界巡回演唱会
火	张惠妹	也许明天
真实	张惠妹	真实
血腥爱情故事	张惠妹	阿密特2
也许明天	张惠妹	也许明天
勇敢	张惠妹	勇敢
哭不出来 (Live)	张惠妹	阿密特 首次世界巡回演唱会
不浪漫罪名	王杰	万岁2001
谁明浪子心	王杰	谁明浪子心
我是真的爱上你	王杰	爱与梦
一场游戏一场梦	王杰	一场游戏一场梦
伤心1999	王杰	从今开始
是否我真的一无所有	王杰	是否我真的一无所有
安妮	王杰	一场游戏一场梦
忘了你忘了我	王杰	忘了你，忘了我
说谎的爱人	王杰	封锁我一生
英雄泪	王杰	英雄泪
她的背影	王杰	是否我真的一无所有
封锁我一生	王杰	封锁我一生
你是我胸口永远的痛	王杰	忘了你，忘了我
心痛	王杰	忘记你不如忘记自己
一无所有	王杰	故事的角色
几分伤心几分痴	王杰	故事的角色
红尘有你	王杰	我
谁明浪子心	王杰	GIVING
回家	王杰	回家
冰冷长街	王杰	一生心碎
会呼吸的痛	梁静茹	崇拜
勇气	梁静茹	勇气
暖暖	梁静茹	亲亲
可惜不是你	梁静茹	丝路
情歌	梁静茹	靜茹 & 情歌 別再为他流泪
问 (Live)	梁静茹	单身必听情歌
宁夏	梁静茹	燕尾蝶
小手拉大手	梁静茹	亲亲
爱你不是两三天	梁静茹	勇气
分手快乐	梁静茹	Sunrise，我喜欢
爱久见人心	梁静茹	爱久见人心
给未来的自己	梁静茹	崇拜
崇拜	梁静茹	崇拜
没有如果	梁静茹	靜茹 & 情歌 別再为他流泪
梦醒时分 (2007“理性与感性”Live)	梁静茹	今天情人节
偶阵雨	梁静茹	爱久见人心
无条件为你	梁静茹	闪亮的星
丝路	梁静茹	丝路
明明很爱你	品冠|梁静茹	门没锁
如果有一天	梁静茹	勇气
为了谁	祖海	天竺少女
好运来	祖海	好运来
牧羊曲	祖海	梦·蝶变
爱在天地间	祖海	好运来
幸福山歌	祖海	单曲 - 幸福山歌
天竺少女	祖海	天竺少女
我家在中国	祖海	单曲 - 我家在中国
再唱为了谁	祖海	再唱为了谁
和谐中国	祖海	单曲 - 和谐中国
今天是你的生日	祖海	好一个花鼓灯·欢乐海
妹妹找哥泪花流	祖海	梦·蝶变
明月千里寄相思	祖海	梦·蝶变
刘三姐	祖海	梦·蝶变
谁的眼泪在飞	祖海	殿堂情歌
连翘花	祖海	连翘花
为了谁	祖海	中国著名作曲家孟庆云作品经典——第一辑<为了谁·长城长>
天堂	祖海	殿堂情歌
月亮代表我的心	祖海	殿堂情歌
东边太阳西边雨	祖海	天竺少女
美丽新天地	祖海	美丽新天地
我的梦	张靓颖	我的梦
另一个天堂	王力宏|张靓颖	心·跳
如果这就是爱情	张靓颖	我相信
终于等到你	张靓颖	第七感
我们说好的	张靓颖	Update
画心	张靓颖	画心
Dream It Possible	张靓颖	Dream It Possible
如果爱下去	张靓颖	The One
只是没有如果	张靓颖|王铮亮	只是没有如果
想你，零点零一分	张靓颖	The One
十里桃花	张靓颖	十里桃花
女儿国	张靓颖	女儿国
有多少爱可以重来	张靓颖	有多少爱可以重来
就算	张靓颖	就算
爱的供养	张杰|张靓颖	拾
雨蝶 (Live)	张靓颖	王牌对王牌第三季 第8期
无字碑	张靓颖	无字碑
饿狼传说 (Live)	张靓颖	BANG THE WORLD
天下无双	张靓颖	神雕侠侣 电视主题曲原声大戏
燕归巢	张靓颖|张杰	燕归巢
匆匆那年	王菲	匆匆那年
岁月	王菲|那英	岁月
红豆	王菲	Eyes On Me
你在终点等我	王菲	你在终点等我
传奇	王菲	传奇
人间	王菲	王菲
容易受伤的女人 (粤语)	王菲	Coming Home
无问西东	王菲	无问西东
因为爱情	陈奕迅|王菲	Stranger Under My Skin
流年	王菲	王菲
笑忘书	王菲	寓言
暗涌	王菲	玩具
暧昧	王菲	Di-Dar
矜持	王菲	天空
清风徐来	王菲	清风徐来
但愿人长久	王菲	菲靡靡之音
执迷不悔 (国语)	王菲	执迷不悔
爱与痛的边缘	王菲	讨好自己
约定	王菲	玩具
棋子	王菲	天空
宿命	刘忻	宿命
太爱你 (TV Version)	刘忻	宫锁沉香 电影原声带
还好遇见	刘忻	寻找爱的冒险 电视剧原声带
老男孩	刘忻	2011快乐女声决赛
Forever 21	刘忻	2011快乐女声七进六
颜色	刘忻	颜色
那片海	刘忻	花开半夏 电视剧原声带
I am the girl from 东北	刘忻	2011快乐女声六进五
十六年	刘忻	神雕侠侣 电视剧原声带
孤单的呼吸	刘忻	另一种灿烂生活 电视剧原声带
羞答答的玫瑰静悄悄地开 (Live)	刘忻	2011快乐女声八进七
because of you (Live)	刘忻	2011快乐女声五进四
残忍的缠绵 (中三版)	刘忻	 
红颜	刘忻|胡彦斌	2011快乐女声四进三
画心	刘忻	空
You are not alone	刘忻	2011快乐女声十进九
一个人 (2016酷狗蘑菇动漫音乐节现场)	刘忻	 
如果有一天 (KTV版伴奏)	刘忻	 
残忍的缠绵 (2016酷狗蘑菇动漫音乐节现场)	刘忻	 
下一次见面你会不会爱上我	刘忻	 
堆积情感	邝美云	心声
只有情永在	张学友|邝美云	张学友24K Gold金藏集
我和春天有个约会	邝美云	我和春天有个约会
寂寞的风	邝美云	堆积情感
再坐一会	邝美云	再坐一会
伤心的我 (粤语版)	邝美云	精装歌集
未曾深爱已无情	邝美云	留住春天
大悲咒	邝美云	禅美云声
最浪漫的事	邝美云	我和春天有个约会
一生只愿爱一次	邝美云	一生只愿爱一次
容易受伤的女人	邝美云	容易受伤的女人
冰冻的女人	邝美云	留住春天
唇印	邝美云	唇印
相逢在半生	邝美云	留下陪我
难得有情人	邝美云	我和春天有个约会
心声	邝美云	心声
亲密爱人	邝美云	我和春天有个约会
与龙共舞	邝美云	爱让每个人都心碎
堆积情感	邝美云	堆积情感
留下了心事	邝美云	心动
你瞒我瞒	陈柏宇	Close Up
尊严	陈柏宇	五年新曲+精选
拍一半拖	陈柏宇	Can't Be Half
别来无恙	陈柏宇	Escape
I Will Be Loving You	陈柏宇	Close Up
逸后	陈柏宇	Close Up
告别之前	陈柏宇	告别之后 音乐剧原声带
原谅我要高飞	陈柏宇	Put On
无可厚非	陈柏宇	Can't Be Half
I Miss You	陈柏宇|冯曦妤	I Miss You
车匙	陈柏宇	车匙
再见不再见	陈柏宇	Put On
固执	陈柏宇	First Experience
永久保存	陈柏宇	First Experience
你来自那颗星	陈柏宇	Change
断绝来往	陈柏宇	First Experience
别怕失去	陈柏宇	别怕失去
多此一爱	陈柏宇	Put On
原谅我怕黑	陈柏宇	Change
理智与感情	陈柏宇	Change
为什么你背着我爱别人	许志安	相信爱情
烂泥	许志安	烂泥
我还能爱谁	许志安	我还能爱谁
苦口良药	许志安	ROMA
会过去的	许志安	Love & Hate
上弦月	许志安	环球最爱巨星系列-许志安
昨迟人	许志安	烂泥
慢慢 (Live)	许志安	蒙面唱将猜猜猜 第1期
恋爱频率	许志安|许慧欣	我还能爱谁
甲乙丙丁	张学友|许志安	不后悔
安静 (Live)	许志安	蒙面唱将猜猜猜 第2期
淘汰 (Live)	许志安	蒙面唱将猜猜猜 第2期
千千阙歌 (Live)	许志安	中国之星 第11期
其实你心里有没有我	许志安|郑秀文	自导/自传
真心真意	许志安	真心真意
教我如何不爱他	许志安	真心真意
乱世俱灭	许志安	蜀山战纪 电视剧原声带
友情岁月 (Live)	许志安	中国之星 第3期
味道 (Live)	周蕙|许志安	蒙面唱将猜猜猜 第2期
Amani (Live)	许志安	中国之星 第6期
从头再来	刘欢	中国歌曲排行榜 1999年度十大金曲
好汉歌	刘欢	歌声飘扬60年——向新中国成立六十周年献礼（第十七集）
弯弯的月亮	刘欢	蒙古小夜曲
千万次的问	刘欢	记住刘欢
这一拜	刘欢	记住刘欢
沧海一声笑 (Live)	那英|周杰伦|刘欢|陈奕迅	中国新歌声第二季 第1期
天地在我心	刘欢	宝莲灯 电影原声音乐
凤凰于飞	刘欢	甄嬛传 电视剧原声带
我和你	刘欢	我和你 2008北京奥运会主题歌
不能这样活	刘欢	歌坛帝王
我欲成仙	刘欢	直接影响
糊涂的爱	刘欢	记住刘欢
在路上	刘欢	在路上
笑傲江湖	刘欢|王菲	笑傲江湖央视版
情怨	刘欢	记住刘欢
卷珠帘 (年度盛典版)	刘欢	新九拍
怀念战友	刘欢	六十年代生人
得民心者得天下	刘欢	一听天下 中国热门电视剧歌曲集
菊花台 (Live)	陈奕迅|刘欢	中国新歌声第二季 第1期
亚洲雄风	刘欢	歌声伴随光辉的50年（3）走进新时代
就现在	吴莫愁	无所不在
我相信	吴莫愁	无所不在
Price Tag (Live)	吴莫愁	2016QQ音乐“最好的时光”跨年演唱会
痒 (Live)	吴莫愁	梦响新歌声第一季 第11期
想神马有神马	吴莫愁	想神马有神马
舞底线	吴莫愁	舞底线
无所不在	吴莫愁	无所不在
贪玩蓝月	吴莫愁	贪玩蓝月
五环之歌 (Live)	吴莫愁	盖世英雄 第3期
Shake Your Body	郭富城|蔡依林|吴莫愁	Shake Your Body
信天游 (Live)	吴莫愁	中国新歌声第二季 第15期
我要给你	庾澄庆|吴莫愁	关不掉的月光
没差	吴莫愁	无所不在
爱爱爱爱	吴莫愁	梦开始的地方
一个人生活 (Live)	吴莫愁	梦响新歌声-天津站
美丽笨女人 (Live)	吴莫愁	2013江苏卫视春晚
Set It All Free (Mandarin Version)	吴莫愁	Sing (Original Motion Picture Soundtrack)
Bad Romance (Live)	吴莫愁	梦响新歌声第一季 第8期
不请自来	吴莫愁	无所不在
Bad Boy (Live)	吴莫愁	盖世英雄 第2期
玻璃之情	张国荣	一切随风
当年情	张国荣	张国荣
风继续吹	张国荣	风继续吹
沉默是金	张国荣	Hot Summer
当爱已成往事	张国荣	宠爱
倩女幽魂	张国荣	Summer Romance
千千阙歌 (90 Live)	张国荣	Miss You Much, Leslie
怪你过分美丽	张国荣	永远张国荣最完整精选全纪录
我 (国语)	张国荣	大热
Monica	张国荣	Leslie
共同渡过	张国荣	Summer Romance
风再起时	张国荣	Final Encounter
有谁共鸣	张国荣	张国荣
春夏秋冬	张国荣	陪你倒数
至少还有你 (00 Live)	张国荣	Miss You Much, Leslie
想你	张国荣	Virgin Snow
无心睡眠	张国荣	20世纪光辉印记DCS声选辑 - 张国荣
追	张国荣	宠爱
今生今世	张国荣	宠爱
夜半歌声	张国荣	宠爱
雨中的恋人们	黄凯芹	Stay With Me
伤感的恋人	黄凯芹	Moody
晚秋	黄凯芹	传闻
若生命等候	黄凯芹	没结果的一些感情
解情还须系情人	黄凯芹	Stay With Me
情深缘浅	黄凯芹	给您留念
哪里的天空不下雨	黄凯芹	平常心
情未了	黄凯芹	黄凯芹给您留念30首
伤尽我心的说话	黄凯芹	环球2000超巨星系列 - 黄凯芹
焚情	黄凯芹	没结果的一些感情
昨夜星辰	黄凯芹	传闻
情归何处	黄凯芹	情归何处
如果你知我苦衷 (Live)	黄凯芹	Unforgettable 演唱会
平常心	黄凯芹	平常心
旧朋友	黄凯芹	Stay With Me
雨中的恋人们	黄凯芹	真经典
相爱很难 (Live)	黄凯芹	港乐×黄凯芹：一夜情弦
哪里的天空不下雨	黄凯芹	像雾像雨又像风
好久不见	黄凯芹	Long Time No See 新曲 + 精选
自制浪漫	黄凯芹	平常心
渴望	毛阿敏	毛阿敏 名曲精选
相思	毛阿敏	天之大
篱笆墙的影子	毛阿敏	毛阿敏影视歌曲集
辘轳·女人和井	毛阿敏	空
烛光里的妈妈	毛阿敏	毛阿敏 名曲精选
不白活一回	毛阿敏	金奖歌后
历史的天空	毛阿敏	天之大
女人不是月亮	毛阿敏	金奖歌后
千古绝唱	毛阿敏	空
永远是朋友	毛阿敏	金奖歌后
我想有个家	毛阿敏	落泪以前·想起往事
跟着感觉走	毛阿敏	明星在哪里
天之大	毛阿敏	天之大
思念	毛阿敏	疯狂歌女
同一首歌	毛阿敏	天之大
绿叶对根的情意	毛阿敏	天之大
我只在乎你	毛阿敏	明星在哪里
神的传说	毛阿敏	封神榜 电视剧原声带
回娘家	毛阿敏	20世纪中华歌坛名人百集珍藏版
爱上张无忌	毛阿敏	天之大
星光灿烂	罗中旭	雕刻时光（中国歌曲排行榜）
如果你不再爱了	罗中旭	如果你不再爱了
听海 (Live)	罗中旭	蒙面唱将猜猜猜 第9期
刺	罗中旭	刺
祝我生日快乐 (Live)	罗中旭	蒙面唱将猜猜猜 第9期
恋人	罗中旭	恋人
见与不见	罗中旭	见与不见
流沙 (Live)	孙楠|罗中旭	蒙面唱将猜猜猜 第8期
让爱靠近	罗中旭	让爱靠近
有你有我	罗中旭	有你有我
爱在你身边	罗中旭	星光灿烂
你快回来 (Live)	罗中旭	我为歌狂 第5期
渔家傲.忆端午	罗中旭	未完待旭 罗中旭经典全记录1995-2017
爱，很简单	罗中旭	我为歌狂 第10期
相信自己	罗中旭	为你自豪
往日情	罗中旭	 
嫁给我吧 (Live)	罗中旭	罗中旭“星光灿烂”20年全国巡回演唱会
暗香 + 梅花三弄 + 爱江山更爱美人 + 快乐至上 + 老男孩 (Live)	罗中旭|伍思凯	我为歌狂 总决赛
为爱存在	罗中旭	为爱存在
你可以不懂	罗中旭	刺
