情非得已	庾澄庆
春泥	庾澄庆
命中注定	庾澄庆
让我一次爱个够	庾澄庆
热情的沙漠	庾澄庆
静静的	庾澄庆
告白气球	庾澄庆
水手	庾澄庆
关不掉的月光	庾澄庆
缺口	庾澄庆
我最摇摆	庾澄庆
梦醒时分	庾澄庆
想念你	庾澄庆
想你，醒在0:03	庾澄庆
快乐颂	庾澄庆
对你爱不完	庾澄庆
新不了情	庾澄庆
改变所有的错	庾澄庆
牧羊曲	郑绪岚
枉凝眉	郑绪岚
太阳岛上	郑绪岚
化蝶	郑绪岚
鼓浪岐之波	郑绪岚
葬花吟	郑绪岚
红楼梦序曲	郑绪岚
大海啊故乡	郑绪岚
妈妈留给我一首歌	郑绪岚
红豆曲	郑绪岚
飞吧鸽子	郑绪岚
沂蒙山小调	郑绪岚
紫菱州歌	郑绪岚
让我们荡起双桨	郑绪岚
大海啊，故乡	郑绪岚
海阔天空	黄贯中
我终于失去了你	黄贯中
特别的爱给特别的你	黄贯中
光辉岁月	黄贯中
大地	黄贯中
吻别	黄贯中
灰色轨迹	黄贯中
再见理想	黄贯中
故事	黄贯中
永远的兄弟	黄贯中
新秩序	黄贯中
爱又怎么样	黄贯中
小姐你好嘢	黄贯中
上海滩	叶丽仪
我们相见又分手	叶丽仪
铁血丹心	叶丽仪
万水千山纵横	叶丽仪
新上海滩	叶丽仪
仙鹤情缘	叶丽仪
笑傲江湖	叶丽仪
何日君再来	叶丽仪
万般情	叶丽仪
时间都去哪儿了	叶丽仪
夜来香	叶丽仪
天涯歌女	叶丽仪
莫问我是谁	叶丽仪
上海滩龙虎斗	叶丽仪
滔滔江水	叶丽仪
红颜	叶丽仪
玫瑰玫瑰我爱你	叶丽仪
肝胆相照	叶丽仪
愿你待我真的好	叶丽仪
只是没有如果	王铮亮
错过	王铮亮
热爱整个世界	王铮亮
默认	王铮亮
越走越远的旅客	王铮亮
还在这里	王铮亮
以爱之名	王铮亮
相爱一场	王铮亮
最远的距离	王铮亮
当我们	王铮亮
还好	王铮亮
我想和你走下去	王铮亮
只愿你好	王铮亮
星月	王铮亮
你是我的	王铮亮
真爱你的云	王铮亮
晴天	关诗敏
好好说再见	关诗敏
别说	关诗敏
时间煮雨	关诗敏
风之恋	关诗敏
屋顶	关诗敏
不远的情人	关诗敏
放过自己	关诗敏
魔法爱情	关诗敏
心动了	关诗敏
来得及说再见	关诗敏
天气预报	关诗敏
渴望	关诗敏
我是真的爱你	关诗敏
刚好遇见你	李玉刚
新贵妃醉酒	李玉刚
清明上河图	李玉刚
雨花石	李玉刚
菩提	李玉刚
水墨丹青	李玉刚
女儿情	李玉刚
独孤天下	李玉刚
霸王别姬	李玉刚
陌上风雅	李玉刚
梨花颂	李玉刚
国色天香	李玉刚
枉凝眉	李玉刚
铁血丹心	李玉刚
逐梦令	李玉刚
我只在乎你	李玉刚
南飞雁	李玉刚
莲花	李玉刚
花魁	李玉刚
就是爱你	陶喆
爱，很简单	陶喆
小镇姑娘	陶喆
爱我还是他	陶喆
普通朋友	陶喆
流沙	陶喆
找自己	陶喆
今天你要嫁给我	陶喆
飞机场的10:30	陶喆
一念之间	陶喆
那个女孩	陶喆
月亮代表谁的心	陶喆
黑色柳丁	陶喆
Susan说	陶喆
二十二	陶喆
我是不是你最疼爱的人	潘越云
痴情不是一种罪过	潘越云
野百合也有春天	潘越云
几度夕阳红	潘越云
天天天蓝	潘越云
最爱	潘越云
谢谢你曾经爱过我	潘越云
痴痴的等	潘越云
京华烟云	潘越云
把悲伤留给自己	潘越云
七重门	潘越云
你会爱我很久吗	潘越云
不了情	潘越云
旧爱新欢	潘越云
爱的箴言	潘越云
是否	潘越云
想你的夜	关喆
如果分开我也爱你	关喆
领悟	关喆
她不爱我	关喆
想定下来	关喆
悟空	关喆
你把我灌醉	关喆
没那么简单	关喆
征服	关喆
忘记你我做不到	关喆
重度寂寞	关喆
我愿意	关喆
天涯共此时	关喆
欲言又止	关喆
给你的歌	关喆
伤痕	关喆
让我一次爱个够	关喆
更好的我们	关喆
永远的永远	关喆
我对我	蔡依林
说爱你	蔡依林
日不落	蔡依林
舞娘	蔡依林
Play我呸	蔡依林
倒带	蔡依林
看我72变	蔡依林
大艺术家	蔡依林
爱情三十六计	蔡依林
特务J	蔡依林
柠檬草的味道	蔡依林
马德里不思议	蔡依林
我知道你很难过	蔡依林
花蝴蝶	蔡依林
许愿池的希腊少女	蔡依林
隐形的翅膀	张韶涵
梦里花	张韶涵
欧若拉	张韶涵
阿刁	张韶涵
淋雨一直走	张韶涵
快乐崇拜	张韶涵
追梦赤子心	张韶涵
遗失的美好	张韶涵
寓言	张韶涵
看得最远的地方	张韶涵
香水百合	张韶涵
全世界失眠	张韶涵
漫步云端	张韶涵
来过我生命的你	张韶涵
有形的翅膀	张韶涵
不想懂得	张韶涵
我曾用心爱你	潘美辰
我想有个家	潘美辰
是你	潘美辰
为何爱情让我痛	潘美辰
写不完的爱	潘美辰
不要走不要走	潘美辰
放弃你是我的错	潘美辰
只要一丝温柔	潘美辰
教我怎么不想你	潘美辰
不懂爱的人	潘美辰
我不在乎	潘美辰
心痛的伤口	潘美辰
其实我好想有人陪	潘美辰
我怕我不是你最爱的人	潘美辰
沧海桑田	潘美辰
只想一生跟你走	潘美辰
舍不得你离去	潘美辰
用我的心我的情感动你	潘美辰
一生托给一个人	潘美辰
爱情诺曼底	黄征
绝不放手	黄征
你是另一个我	黄征
奔跑	黄征
地铁	黄征
一个人的战役	黄征
爱,值得	黄征
爱情傻瓜	黄征
一无所有时爱你的人	黄征
春梦	黄征
茶花女爱上毕加索	黄征
壮志豪情	黄征
平行线	黄征
破晓	黄征
当你从我眼中离开	黄征
小气鬼	黄征
信仰	黄征
归来	黄征
比爱更爱	黄征
在那桃花盛开的地方	蒋大为
牡丹之歌	蒋大为
最美的歌儿唱给妈妈	蒋大为
敢问路在何方	蒋大为
骏马奔驰保边疆	蒋大为
北国之春	蒋大为
有一个美丽的传说	蒋大为
驼铃	蒋大为
十五的月亮	蒋大为
草原上升起不落的太阳	蒋大为
九九艳阳天	蒋大为
乌苏里船歌	蒋大为
敖包相会	蒋大为
桃花依旧笑春风	蒋大为
跑马溜溜的山上	蒋大为
送别	蒋大为
草原之夜	蒋大为
大坂城的姑娘	蒋大为
骏马奔腾保边疆	蒋大为
拯救	孙楠
留什么给你	孙楠
你快回来	孙楠
风往北吹	孙楠
只要有你	孙楠
缘分的天空	孙楠
不见不散	孙楠
红旗飘飘	孙楠
爱你爱不够	孙楠
净土	孙楠
是否爱过我	孙楠
漂洋过海来看你	孙楠
千秋	孙楠
传奇	孙楠
新的天地	孙楠
爱情抗体	许慧欣
七月七日晴	许慧欣
孤单芭蕾	许慧欣
恋爱频率	许慧欣
忽然很想你	许慧欣
诗水蛇山神庙	许慧欣
幸福的味道	许慧欣
心动心痛	许慧欣
大风吹	许慧欣
一个人唱歌	许慧欣
陪你等天亮	许慧欣
两个人的下雪天	许慧欣
独立宣言	许慧欣
爱情轮廓	许慧欣
纯属意外	许慧欣
倾国倾城	熊汝霖
一如既往	熊汝霖
自由自在	熊汝霖
生而倔强	熊汝霖
送福星	熊汝霖
最美的意外	熊汝霖
熊不再出没，请注意！	熊汝霖
天下无敌	熊汝霖
熊的狂想曲	熊汝霖
面朝大海	熊汝霖
最近的远方	熊汝霖
春天的芭蕾	常思思
玛依拉变奏曲	常思思
注定	常思思
唱支山歌给党听	常思思
问春	常思思
我爱我的祖国	常思思
听海	常思思
军港之夜	常思思
这片海有我	常思思
江山	常思思
英雄赞歌	常思思
情深谊长	常思思
红太阳照边疆	常思思
阿瓦人民唱新歌	常思思
思源	常思思
汉服青史	常思思
因为有你	常思思
每一步	徐小凤
顺流逆流	徐小凤
风的季节	徐小凤
明月千里寄相思	徐小凤
漫漫前路	徐小凤
别亦难	徐小凤
南屏晚钟	徐小凤
今宵多珍重	徐小凤
风雨同路	徐小凤
天涯歌女	徐小凤
心恋	徐小凤
浪子心声	徐小凤
一生所爱	徐小凤
花好月圆	徐小凤
分飞燕	徐小凤
何日君再来	徐小凤
问情	徐小凤
不了情	徐小凤
月光小夜曲	徐小凤
潇洒走一回	叶倩文
曾经心痛	叶倩文
祝福	叶倩文
真心真意过一生	叶倩文
情人知己	叶倩文
选择	叶倩文
珍重	叶倩文
爱上一个不回家的人	叶倩文
秋去秋来	叶倩文
爱的可能	叶倩文
哭砂	叶倩文
酒干倘卖无	叶倩文
我是不是你最疼爱的人	叶倩文
伤逝	叶倩文
其实你不懂我的心	叶倩文
驿动的心	叶倩文
红尘	叶倩文
焚心以火	叶倩文
无言的结局	叶倩文
特别的爱给特别的你	伍思凯
爱与愁	伍思凯
爱要怎么说	伍思凯
我真的很不错	伍思凯
情网	伍思凯
爱的钢琴手	伍思凯
不要再提我的名字	伍思凯
分享	伍思凯
等着你爱着你	伍思凯
爱你一世到来生	伍思凯
且行且珍惜	伍思凯
不只是朋友	伍思凯
分别以后才懂得拥有	伍思凯
想念	伍思凯
短发	梁咏琪
胆小鬼	梁咏琪
中意他	梁咏琪
原来爱情这么伤	梁咏琪
花火	梁咏琪
爱的代价	梁咏琪
错过	梁咏琪
向左走向右走	梁咏琪
新鲜	梁咏琪
凹凸	梁咏琪
爱得起	梁咏琪
天使与海豚	梁咏琪
有时候	梁咏琪
我钟意	梁咏琪
偏见	梁咏琪
我只在乎你	梁咏琪
找一个字代替	邰正宵
千纸鹤	邰正宵
心要让你听见	邰正宵
一千零一夜	邰正宵
九百九十九朵玫瑰	邰正宵
好人好梦	邰正宵
用情太深	邰正宵
心太冷	邰正宵
想你想得好孤寂	邰正宵
山水画	邰正宵
爱归零	邰正宵
情人之间的情人	邰正宵
相思如麻	邰正宵
纸飞机	邰正宵
爱的传说	邰正宵
泪流一千遍	邰正宵
寸寸相思寸寸心	邰正宵
我的心在冷风里飞	邰正宵
难得有情人	关淑怡
深夜港湾	关淑怡
缱绻星光下	关淑怡
明天你是否依然爱我	关淑怡
星空下的恋人	关淑怡
地老天荒	关淑怡
梦伴	关淑怡
忘记他	关淑怡
一切也愿意	关淑怡
只想您会意	关淑怡
问	关淑怡
无尽的爱	关淑怡
双星情歌	关淑怡
只得一次	关淑怡
断点	张敬轩
吻得太逼真	张敬轩
只是太爱你	张敬轩
春秋	张敬轩
樱花树下	张敬轩
酷爱	张敬轩
囍帖街	张敬轩
可惜我是水瓶座	张敬轩
不吐不快	张敬轩
骚灵情歌	张敬轩
黄色大门	张敬轩
尘埃落定	张敬轩
绝	张敬轩
笑忘书	张敬轩
好心分手	张敬轩
无能为力	张敬轩
灵魂相认	张敬轩
爱的故事上集	张敬轩
我的眼里只有你	景岗山
兄弟无数	景岗山
守业更比创业难	景岗山
寂寞是因为思念谁	景岗山
我的眼中只有你	景岗山
中国山	景岗山
我知道你在等着我	景岗山
策马啸西风	景岗山
我是不是还能爱你	景岗山
红豆	景岗山
因为我是男人	景岗山
一天成永远	景岗山
重新再来	景岗山
山里的汉子	景岗山
人人都热爱迪斯科	景岗山
爱你几回不流泪	景岗山
你有一种惊心动魄的美	景岗山
多少年以后你懂	景岗山
都是夜归人	许美静
遗憾	许美静
城里的月光	许美静
放你在心里	许美静
阳光总在风雨后	许美静
倾城	许美静
明知故犯	许美静
蔓延	许美静
荡漾	许美静
铁窗	许美静
你抽的烟	许美静
快乐无罪	许美静
边界1999	许美静
迷乱	许美静
放在你心里	许美静
只是这人生	许美静
迫在眉梢	许美静
爱一点	莫艳琳
别了，耳听爱情的年纪	莫艳琳
带走	莫艳琳
平凡之路	莫艳琳
看海	莫艳琳
过火	莫艳琳
醒来再做梦	莫艳琳
亲爱的	莫艳琳
好久不见	莫艳琳
风吹麦浪	莫艳琳
错的是我	莫艳琳
你的背包	莫艳琳
天蝎和处女	莫艳琳
黑白电影	莫艳琳
值得	郑秀文
唉声叹气	郑秀文
终身美丽	郑秀文
独一无二	郑秀文
眉飞色舞	郑秀文
出界	郑秀文
默契	郑秀文
不拖不欠	郑秀文
煞科	郑秀文
信者得爱	郑秀文
爱的挽歌	郑秀文
插曲	郑秀文
唯独你是不可取替	郑秀文
为何又是这样错	郑秀文
如何掉眼泪	郑秀文
独家试唱	郑秀文
放不低	郑秀文
认真地老去	曹方
面包	曹方
遇见我	曹方
比天空还远	曹方
飘起来的房子和勇士	曹方
我的北京	曹方
南部小城	曹方
明白	曹方
风吹过下雨天	曹方
决定	曹方
等人	曹方
城市稻草人	曹方
在	曹方
冰川	曹方
被拥抱的荒岛	曹方
想把我唱给你听	曹方
春花秋开	曹方
我是认真的	曹方
痴心绝对	李圣杰
手放开	李圣杰
你那么爱她	李圣杰
最近	李圣杰
关于你的歌	李圣杰
说散就散	李圣杰
每次都想呼喊你的名字	李圣杰
离人	李圣杰
不顾一切的爱	李圣杰
擦肩而过	李圣杰
安静	李圣杰
如果你爱他	李圣杰
远走高飞	李圣杰
我以为	李圣杰
眼底星空	李圣杰
听说	李圣杰
手掌印	江若琳
原来我还爱着你	江若琳
错爱	江若琳
眼泪无用	江若琳
太早	江若琳
最好的时光	江若琳
伤情路	江若琳
你不在了	江若琳
你给我力量	江若琳
爱你还是爱美	江若琳
勇敢爱	江若琳
旁观者伤	江若琳
爱无可忍	江若琳
童话	江若琳
撒娇	江若琳
新不了情	江若琳
活着	郝云
去大理	郝云
突然想到理想这个词	郝云
结了	郝云
如果来生还能遇见你	郝云
该装就装	郝云
北京	郝云
群发的我不回	郝云
回到那一天	郝云
四季不败	郝云
卖艺的小青年	郝云
一声叹息	郝云
逃跑的木偶	郝云
如果生命只剩最后一天	郝云
这个城市	郝云
情谣	郝云
姥姥说	郝云
天马行空	郝云
五百万	郝云
约定	周蕙
好想好好爱你	周蕙
风铃	周蕙
不想让你知道	周蕙
相遇太早	周蕙
不爱了也是一种爱	周蕙
替身	周蕙
话题	周蕙
爱的箴言	周蕙
情人	周蕙
相思风雨中	周蕙
预言	周蕙
思念的翅膀	周蕙
今宵多珍重	周蕙
事到如今	周蕙
我喜欢	周蕙
该忘了你对不对	周蕙
我要我们在一起	范晓萱
我爱洗澡	范晓萱
雪人	范晓萱
健康歌	范晓萱
氧气	范晓萱
小叮当	范晓萱
眼泪	范晓萱
稍息立正站好	范晓萱
你的甜蜜	范晓萱
深呼吸	范晓萱
哭了	范晓萱
豆豆龙	范晓萱
同步	范晓萱
刷牙歌	范晓萱
管他什么音乐	范晓萱
那种女孩	范晓萱
自言自语	范晓萱
消失	范晓萱
三月里的小雨	刘文正
雨中即景	刘文正
童年	刘文正
迟到	刘文正
阿美阿美	刘文正
梅兰梅兰我爱你	刘文正
恰似你的温柔	刘文正
相思河畔	刘文正
兰花草	刘文正
外婆的澎湖湾	刘文正
小秘密	刘文正
耶利亚女郎	刘文正
送你一朵勿忘我	刘文正
多少柔情多少泪	刘文正
闪亮的日子	刘文正
爱像什么	刘文正
诺言	刘文正
太阳一样	刘文正
散场	刘文正
太傻	巫启贤
思念谁	巫启贤
爱那么重	巫启贤
人生如梦	巫启贤
别以为男人就不会哭	巫启贤
为了你	巫启贤
红尘来去一场梦	巫启贤
等你等到我心痛	巫启贤
只因你伤心	巫启贤
用心良苦	巫启贤
想着你的感觉	巫启贤
心酸的情歌	巫启贤
爱情傀儡	巫启贤
你是我的唯一	巫启贤
我没有钱我不要脸	巫启贤
团圆	巫启贤
只想一生跟你走	巫启贤
用心良苦	周华健
爱相随	周华健
传奇	周华健
凡人歌	周华健
风雨无阻	周华健
难念的经	周华健
花心	周华健
让我欢喜让我忧	周华健
有没有一首歌会让你想起我	周华健
刀剑如梦	周华健
其实不想走	周华健
朋友	周华健
孤枕难眠	周华健
天下有情人	周华健
神话情话	周华健
漂洋过海来看你	周华健
忘忧草	周华健
江湖笑	周华健
现代爱情故事	许秋怡
偷偷想你	许秋怡
片片枫叶情	许秋怡
难得有情人	许秋怡
分手	许秋怡
抱紧我心	许秋怡
梦断	许秋怡
悲欢离合	许秋怡
温馨的目光	许秋怡
爱至死不休	许秋怡
夜雨打痛我心	许秋怡
盼可有日再遇	许秋怡
似梦似真	许秋怡
夕阳之恋	许秋怡
爱上一个爱我也爱她的人	许秋怡
相恋多一次	许秋怡
坏天使	江映蓉
把握你的美	江映蓉
以人民的名义	江映蓉
坏天使2.1	江映蓉
闪闪惹人爱	江映蓉
漂亮	江映蓉
当	江映蓉
表白	江映蓉
热门花招	江映蓉
爱情鸟	江映蓉
最爱的人伤我最深	江映蓉
歌曲串烧	江映蓉
涛声依旧	毛宁
晚秋	毛宁
蓝蓝的夜蓝蓝的梦	毛宁
我是不是该安静的走开	杨钰莹
心雨	毛宁
是否还会想起我	毛宁
等你在老地方	毛宁
大浪淘沙	毛宁
阿哥阿妹情意长	毛宁
友谊天长地久	毛宁
我心永恒	毛宁
能有几次这样的爱	杨钰莹
两个人	那英
默	那英
有个爱你的人不容易	那英
白天不懂夜的黑	那英
征服	那英
一笑而过	那英
岁月	那英
春暖花开	那英
雾里看花	那英
三生三世十里桃花	那英
相爱恨早	那英
山不转水转	那英
不管有多苦	那英
愿赌服输	那英
相约一九九八	那英
出卖	那英
暧昧	侯湘婷
秋天别来	侯湘婷
我是一只鱼	侯湘婷
我是如此爱你	侯湘婷
两个冬天	侯湘婷
你爱我吗	侯湘婷
为你流的泪	侯湘婷
冷战	侯湘婷
一起去巴黎	侯湘婷
风晓得	侯湘婷
昨天今天明天	侯湘婷
你要好好的	侯湘婷
原来的你	侯湘婷
都是真的	侯湘婷
一个人的星期天	侯湘婷
秋天以后的故事	侯湘婷
离开爱的日子	侯湘婷
真夏的公车	侯湘婷
那女孩对我说	黄义达
显微镜下的爱情	黄义达
一秒的安慰	黄义达
写给自己的歌	黄义达
蓝天	黄义达
专属密码	黄义达
微光	黄义达
匿名的宝贝	黄义达
目击者	黄义达
保留	黄义达
我懂	黄义达
如果爱	黄义达
爱了才懂	黄义达
我不哭	黄义达
每天的每夜	黄义达
喜欢你（喜欢我）	黄义达
老情歌	黄义达
滚滚长江东逝水	杨洪基
向天再借五百年	杨洪基
莫斯科郊外的晚上	杨洪基
雁南飞	杨洪基
我和我的祖国	杨洪基
美丽的草原我的家	杨洪基
万水千山总是情	杨洪基
三套车	杨洪基
多情的土地	杨洪基
短歌行	杨洪基
再回首	杨洪基
满江红	杨洪基
在水一方	杨洪基
伊犁河的月夜	杨洪基
重整山河待后生	杨洪基
共和国之恋	杨洪基
敖包相会	杨洪基
祖国，慈祥的妈妈	杨洪基
那是你离开了北京的生活	薛之谦
肆无忌惮	薛之谦
怪咖	薛之谦
哑巴	薛之谦
刚刚好	薛之谦
你还要我怎样	薛之谦
演员	薛之谦
醒来	薛之谦
绅士	薛之谦
暧昧	薛之谦
我好像在哪见过你	薛之谦
意外	薛之谦
天后	薛之谦
像风一样	薛之谦
方圆几里	薛之谦
动物世界	薛之谦
丑八怪	薛之谦
摩天大楼	薛之谦
铁齿铜牙纪晓岚	戴娆
故事就是故事	戴娆
百姓的事儿牵着走	戴娆
绽放	戴娆
念念不忘	戴娆
爱是仙上仙	戴娆
靠近你,	戴娆
思绪如潮	戴娆
相思	戴娆
布衣知县梵如花	戴娆
我爱我家	戴娆
幸福来敲门	戴娆
落泪的玫瑰	戴娆
情纠缠	戴娆
爱你就在一瞬间	戴娆
风儿告诉我	戴娆
爱你,	戴娆
还是家乡好	戴娆
美人吟	李玲玉
粉红色的回忆	李玲玉
天竺少女	李玲玉
女儿情	李玲玉
你潇洒我漂亮	李玲玉
无奈的思绪	李玲玉
是酒也是泪	李玲玉
情网	李玲玉
为了你	李玲玉
信天游	李玲玉
笑红尘	李玲玉
我是不是该安静地走开	李玲玉
除了你	李玲玉
人在旅途	李玲玉
窗外	李玲玉
妈妈的吻	李玲玉
敬祝毛主席万寿无疆	李玲玉
爱你真好难	李玲玉
采茶舞曲	李玲玉
耿耿于怀	麦浚龙
罗生门	麦浚龙
念念不忘	麦浚龙
如果可以待你好	麦浚龙
有人	麦浚龙
借火	麦浚龙
彳亍	麦浚龙
弱水三千	麦浚龙
雷克雅未克	麦浚龙
蒙	麦浚龙
吃鲸鱼的人	麦浚龙
可不可不撑下去	麦浚龙
单鱼座	麦浚龙
自己保重	麦浚龙
禽兽	麦浚龙
樱吹雪	麦浚龙
没有人	麦浚龙
睡前服	麦浚龙
梦醒时分	陈淑桦
笑红尘	陈淑桦
滚滚红尘	陈淑桦
问	陈淑桦
流光飞舞	陈淑桦
这样爱你对不对	陈淑桦
明明白白我的心	陈淑桦
聪明糊涂心	陈淑桦
说，你爱我	陈淑桦
生生世世	陈淑桦
做个真的我	陈淑桦
当真就好	陈淑桦
一生爱你千百回	梅艳芳
夕阳之歌	梅艳芳
女人花	梅艳芳
似是故人来	梅艳芳
相爱很难	梅艳芳
胭脂扣	梅艳芳
风的季节	梅艳芳
下辈子别再做女人	梅艳芳
孤身走我路	梅艳芳
似水流年	梅艳芳
今宵多珍重	梅艳芳
你把我灌醉	梅艳芳
烈焰红唇	梅艳芳
用心良苦	梅艳芳
芳华绝代	梅艳芳
梦伴	梅艳芳
特别的人	方大同
三人游	方大同
春风吹	方大同
爱爱爱	方大同
红豆	方大同
因为你	方大同
每个人都会	方大同
为你写的歌	方大同
复刻回忆	方大同
四人游	方大同
黑白	方大同
千纸鹤	方大同
关于爱的定义	方大同
够不够	方大同
苏丽珍	方大同
悟空	方大同
精忠报国	屠洪刚
你	屠洪刚
霸王别姬	屠洪刚
江山无限	屠洪刚
中国功夫	屠洪刚
风云	屠洪刚
藏龙卧虎	屠洪刚
爱人	屠洪刚
孔雀东南飞	屠洪刚
对酒当歌	屠洪刚
龙的传人	屠洪刚
风云2	屠洪刚
我心为谁动	屠洪刚
叶问霜天	屠洪刚
独占潇洒	屠洪刚
我的心	屠洪刚
莽原	屠洪刚
龙行天下	屠洪刚
阿里山的姑娘	屠洪刚
雨蝶	李翊君
诺言	李翊君
风中的承诺	李翊君
多情人把灵魂都给了谁	李翊君
永远永远	李翊君
七情六欲	李翊君
痛	李翊君
萍聚	李翊君
漂洋过海来看你	李翊君
花开花落	李翊君
沙漠寂寞	李翊君
最爱最恨都是你	李翊君
爱我，你怕了吗	李翊君
容易受伤的女人	李翊君
不让我的眼泪陪我过夜	李翊君
红尘	李翊君
明天你是否依然爱我	李翊君
谢谢你让我这么爱你	柯以敏
河流	柯以敏
太傻	柯以敏
爱我	柯以敏
美丽	柯以敏
她在睡前哭泣	柯以敏
断了线	柯以敏
空船	柯以敏
我用生命爱你	柯以敏
思念是一种惩罚	柯以敏
拥抱我	柯以敏
在秋天醒来	柯以敏
让生命重来	柯以敏
邻居的耳朵	柯以敏
电台情歌	柯以敏
鸭子	苏慧伦
原来你也在这里	苏慧伦
被动	苏慧伦
哭过的天空	苏慧伦
黄色月亮	苏慧伦
我一个人住	苏慧伦
相见不如怀念	苏慧伦
秋天的海	苏慧伦
在我生命中的每一天	苏慧伦
傻瓜	苏慧伦
失恋万岁	苏慧伦
虎口脱险	苏慧伦
原点	苏慧伦
相见恨晚	苏慧伦
还剩下什么	苏慧伦
没离开过	林志炫
烟花易冷	林志炫
单身情歌	林志炫
你的样子	林志炫
蒙娜丽莎的眼泪	林志炫
离人	林志炫
浮夸	林志炫
凤凰花开的路口	林志炫
卷珠帘	林志炫
输了你赢了世界又如何	林志炫
夜夜夜夜	林志炫
散了吧	林志炫
你的眼神	林志炫
空	林志炫
御龙铭千古	林志炫
哭砂	林志炫
离歌	林志炫
山丘	李宗盛
给自己的歌	李宗盛
新写的旧歌	李宗盛
鬼迷心窍	李宗盛
漂洋过海来看你	李宗盛
凡人歌	李宗盛
我终于失去了你	李宗盛
领悟	李宗盛
爱的代价	李宗盛
问	李宗盛
我是真的爱你	李宗盛
再回首	李宗盛
不必在乎我是谁	李宗盛
寂寞难耐	李宗盛
梦醒时分	李宗盛
晚婚	李宗盛
壮志在我胸	李宗盛
天不下雨天不刮风天上有太阳	于文华
跟你走天涯	尹相杰
甘十九妹	尹相杰
偷一颗月亮照亮天	尹相杰
天不下雨,天不刮风,天上有太阳	尹相杰
摇花轿	尹相杰
爱谁是谁	尹相杰
欢天喜地奔小康	尹相杰
好男人	尹相杰
纤夫的梦	尹相杰
上有老下有小	尹相杰
老鼠爱大米	杨臣刚
老公PK老婆	杨臣刚
真的爱你	杨臣刚
南无阿弥了陀佛	杨臣刚
龙	杨臣刚
男人的歌	杨臣刚
大话西游	杨臣刚
可不可以不想你	杨臣刚
撸起袖子加油干	杨臣刚
钱钱钱	杨臣刚
好兄弟	杨臣刚
老板难当	杨臣刚
我们是一家人	杨臣刚
我是你老公	杨臣刚
一生只为你	杨臣刚
活着不容易	杨臣刚
兔子爱萝卜	杨臣刚
有没有	韦礼安
女孩	韦礼安
还是会	韦礼安
慢慢等	韦礼安
因为爱	韦礼安
别说没爱过	韦礼安
面具	韦礼安
第一个想到你	韦礼安
一个人	韦礼安
有人在等我	韦礼安
爱如空气	韦礼安
似曾	韦礼安
在你身边	韦礼安
不需要知道	韦礼安
还是爱着你	韦礼安
人质	韦礼安
狼	韦礼安
如果再见	韦礼安
下个，路口，见	李宇春
动物世界	李宇春
1987我不知会遇见你	李宇春
和你一样	李宇春
再不疯狂我们就老了	李宇春
野蛮生长	李宇春
蜀绣	李宇春
流行	李宇春
春风十里	李宇春
漂洋过海来看你	李宇春
唐人街	李宇春
今天雨，可是我们在一起	李宇春
千年游	李宇春
西门少年	李宇春
对不起，只是忽然很想你	李宇春
珍惜	李宇春
口音	李宇春
一趟	李宇春
偏偏喜欢你	陈百强
一生何求	陈百强
今宵多珍重	陈百强
念亲恩	陈百强
等	陈百强
不	陈百强
涟漪	陈百强
深爱着你	陈百强
眼泪为你流	陈百强
烟雨凄迷	陈百强
一生不可自决	陈百强
天才白痴梦	陈百强
当我想起你	陈百强
盼三年	陈百强
对酒当歌	陈百强
喝彩	陈百强
相思河畔	陈百强
摘星	陈百强
走进新时代	张也
万事如意	张也
人间第一情	张也
高天上流云	张也
枉凝眉	张也
家和万事兴	张也
小曲好唱口难开	张也
在希望的田野上	张也
九九艳阳天	张也
泉水叮咚响	张也
月亮走,我也走	张也
沂蒙山小调	张也
十送红军	张也
化蝶	张也
父亲	张也
祖国你好	张也
咱老百姓	张也
山笑水笑人欢笑	张也
枉凝眉	于文华
痴情小妹妹	于文华
丈夫辛苦了	于文华
沂蒙山小调	于文华
贵妃醉酒	于文华
今天我做你的新娘	于文华
中华全家福	于文华
花为媒·夸月娥	于文华
老毕的爱	于文华
你的生命如此美丽	于文华
想起老妈妈	于文华
绣鸳鸯	于文华
沿着社会主义大道奔前方	于文华
爱与诚	古巨基
情歌王	古巨基
爱得太迟	古巨基
劲歌金曲	古巨基
好想好想	古巨基
必杀技	古巨基
恋无可恋	古巨基
匆匆那年	古巨基
情人	古巨基
重复犯错	古巨基
找到你是我最伟大的成功	古巨基
突然好想你	古巨基
爆了	古巨基
眼睛不能没眼泪	古巨基
何必打扰	古巨基
忘了时间的钟	古巨基
父亲	古巨基
劲歌金曲3	古巨基
朋友	臧天朔
爱到永远	臧天朔
山歌好比春江水	臧天朔
分别的时候	臧天朔
路边的野花不要采	臧天朔
哥哥把你栓在心头	臧天朔
我祈祷	臧天朔
心经	臧天朔
梦蝶	臧天朔
都在等着你	臧天朔
等待那一天	臧天朔
老玉米	臧天朔
我终于失去了你	赵传
爱要怎么说出口	赵传
我是一只小小鸟	赵传
我很丑，可是我很温柔	赵传
给所有知道我名字的人	赵传
勇敢一点	赵传
把悲伤留给自己	赵传
你如何还能这样温柔	赵传
我的心好乱	赵传
一颗滚石	赵传
沉默的羔羊	赵传
每次都想呼喊你的名字	赵传
那个傻瓜爱过你	赵传
大地	赵传
请不要在别人的肩上哭泣	赵传
曾经的你	赵传
噢！莎莉	赵传
我一直以为你知道	赵传
喜欢你现在的样子	黄韵玲
听！是谁在唱歌	黄韵玲
心动	黄韵玲
三个人的晚餐	黄韵玲
听一首伤心的歌	黄韵玲
生命中的精灵	黄韵玲
春暖花开	黄韵玲
简单的事情	黄韵玲
女朋友男朋友	黄韵玲
你是唯一	黄韵玲
至少还有你	黄韵玲
天黑黑	黄韵玲
改变	黄韵玲
我在这里等你	黄韵玲
青鸟	黄韵玲
你的承诺	海鸣威
老人与海	海鸣威
我的回忆不是我的	海鸣威
一个人的北京	海鸣威
工体爱情故事	海鸣威
分开以后	海鸣威
人海	海鸣威
爱没有谁对不起谁	海鸣威
离开为了更好的回来	海鸣威
身不由己	海鸣威
伤心的海	海鸣威
落叶	海鸣威
舞动全城	海鸣威
在月光下歌唱	海鸣威
浪子心声	许冠杰
沉默是金	许冠杰
沧海一声笑	许冠杰
天才与白痴	许冠杰
打雀英雄传	许冠杰
梨涡浅笑	许冠杰
有酒今朝醉	许冠杰
阿郎恋曲	许冠杰
天才白痴梦	许冠杰
双星情歌	许冠杰
十个女仔	许冠杰
最佳拍档	许冠杰
日本娃娃	许冠杰
知音梦里寻	许冠杰
无情夜冷风	许冠杰
何日再相逢	许冠杰
父母恩	许冠杰
学生哥	许冠杰
给所有知道我名字的人	罗琦
我期待	罗琦
随心所欲	罗琦
我是一只小小鸟	罗琦
回来	罗琦
我没有远方	罗琦
我相信	罗琦
把你唱醉	罗琦
重生	罗琦
敲响天堂之门	罗琦
我	罗琦
雨夜里的烦恼	罗琦
不想再是小孩	罗琦
让我自己来	罗琦
背叛	曹格
寂寞先生	曹格
梁山伯与茱丽叶	曹格
掌纹	曹格
数到五答应我	曹格
无辜	曹格
世界唯一的你	曹格
我很丑可是我很温柔	曹格
两只恋人	曹格
海阔天空	曹格
爷爷	曹格
入戏	曹格
丑角	曹格
明天会更好	曹格
吹吹风	曹格
你是我的宝贝	曹格
借我一辈子	曹格
亲爱的你怎么不在我身边	江美琪
那年的情书	江美琪
想起	江美琪
路人	江美琪
东京铁塔的幸福	江美琪
我又想起你	江美琪
爱哭鬼	江美琪
他一定很爱你	江美琪
对你有感觉	江美琪
朋友的朋友	江美琪
我心似海洋	江美琪
夜的诗人	江美琪
双手的温柔	江美琪
星晴	江美琪
袖手旁观	江美琪
亲爱的你怎么不在身边	江美琪
凝望	江美琪
最美	江美琪
执着	田震
风雨彩虹铿锵玫瑰	田震
风雨彩虹	田震
好大一棵树	田震
跟着感觉走	田震
靠近我	田震
月牙泉	田震
黄土高坡	田震
爱不后悔	田震
水姻缘	田震
怕黑的女人	田震
阿里山的姑娘	田震
谁为我停留	田震
玩儿个痛快	田震
我热恋的故乡	田震
未了情	田震
又见炊烟	田震
北国之春	田震
让我再看你一眼	田震
预谋	许佳慧
宽容	许佳慧
一拍两散	许佳慧
别把借口当理由	许佳慧
本末倒置	许佳慧
我在神经什么	许佳慧
说好一起走	许佳慧
平行线	许佳慧
你想好怎么对她说	许佳慧
真的爱上你	许佳慧
情歌唱给自己听	许佳慧
转身离开	许佳慧
我别这样好不好	许佳慧
诡爱	许佳慧
回到那时候	许佳慧
在一块	许佳慧
左手爱了右手痛	许佳慧
这又何必	许佳慧
吻过爱过的你	许佳慧
慢慢	张学友
如果这都不算爱	张学友
只想一生跟你走	张学友
遥远的她	张学友
一路上有你	张学友
一千个伤心的理由	张学友
吻别	张学友
她来听我的演唱会	张学友
等你等到我心痛	张学友
忘记你我做不到	张学友
饿狼传说	张学友
心如刀割	张学友
回头太难	张学友
想和你去吹吹风	张学友
旧情绵绵	张学友
情书	张学友
你最珍贵	张学友
相思风雨中	张学友
我真的受伤了	张学友
我以为	品冠
那些女孩教我的事	品冠
掌心	品冠
我不愿让你一个人	品冠
疼你的责任	品冠
无可救药	品冠
陪你一起老	品冠
后来的我们	品冠
哄我入睡	品冠
门没锁	品冠
又一年又三年	品冠
我一个人记得就好	品冠
为你我想做更好的人	品冠
随时都在	品冠
未拆的礼物	品冠
我不难过	品冠
还好有你	品冠
醉赤壁	林俊杰
那些你很冒险的梦	林俊杰
可惜没如果	林俊杰
不为谁而作的歌	林俊杰
修炼爱情	林俊杰
她说	林俊杰
江南	林俊杰
当你	林俊杰
背对背拥抱	林俊杰
爱要怎么说出口	林俊杰
爱笑的眼睛	林俊杰
一千年以后	林俊杰
我还想她	林俊杰
小酒窝	林俊杰
曹操	林俊杰
关键词	林俊杰
输了你赢了世界又如何	林俊杰
美人鱼	林俊杰
囚鸟	彭羚
让我跟你走	彭羚
如梦初醒	彭羚
你未讲过	彭羚
我有我天地	彭羚
缠绵游戏	彭羚
完全因你	彭羚
小玩意	彭羚
仍然是最爱你	彭羚
彷如隔世	彭羚
烂泥	彭羚
心淡	彭羚
爱过痛过亦愿等	彭羚
爱我别走	彭羚
情书	彭羚
重回那天那地	彭羚
挥着翅膀的女孩	容祖儿
独照	容祖儿
小小	容祖儿
习惯失恋	容祖儿
心淡	容祖儿
怯	容祖儿
16号爱人	容祖儿
心之科学	容祖儿
痛爱	容祖儿
月半小夜曲	容祖儿
连续剧	容祖儿
一拍两散	容祖儿
花千树	容祖儿
破相	容祖儿
烟霞	容祖儿
想着你的感觉	容祖儿
续集	容祖儿
共你痴痴爱在	容祖儿
天窗	容祖儿
私奔	郑钧
灰姑娘	郑钧
回到拉萨	郑钧
流星	郑钧
赤裸裸	郑钧
长安长安	郑钧
要死就一定要死在你手里	郑钧
热爱	郑钧
天下没有不散的筵席	郑钧
风马	郑钧
极乐世界	郑钧
花儿为什么这样红	郑钧
爱的箴言	郑钧
路漫漫	郑钧
喀秋莎	郑钧
老男孩	郑钧
夜色	郑钧
商品社会	郑钧
冬季到台北来看雨	孟庭苇
风中有朵雨做的云	孟庭苇
羞答答的玫瑰静悄悄地开	孟庭苇
谁的眼泪在飞	孟庭苇
你看你看月亮的脸	孟庭苇
你究竟有几个好妹妹	孟庭苇
无声的雨	孟庭苇
没有情人的情人节	孟庭苇
一个爱上浪漫的人	孟庭苇
往事	孟庭苇
伤了你的心的我的心	孟庭苇
红雨	孟庭苇
野百合也有春天	孟庭苇
三生三世	孟庭苇
雾里看花	孟庭苇
你那里下雪了吗	孟庭苇
真的还是假的	孟庭苇
春花秋月何时了	孟庭苇
我只在乎你	孟庭苇
高级动物	窦唯
噢！乖	窦唯
艳阳天	窦唯
怕你为自己流泪	窦唯
黑色梦中	窦唯
悲伤的梦	窦唯
窗外	窦唯
上帝保佑	窦唯
雨吁	窦唯
明天更漫长	窦唯
迷走江湖	窦唯
暮春秋色	窦唯
山河水	窦唯
希望之光	窦唯
重返魔域	窦唯
开心电话	窦唯
送别2017	窦唯
直到时间尽头	赵静怡
蜕变	赵静怡
小叮当	赵静怡
点燃未来	赵静怡
怎么了	袁咏琳
刺猬的拥抱	袁咏琳
黑色幽默	袁咏琳
心底	袁咏琳
陷阱	袁咏琳
只好倔强	袁咏琳
你想娶我吗	袁咏琳
爱是黑白	袁咏琳
安排	袁咏琳
热气球	袁咏琳
把伤心打碎	袁咏琳
雨后天空	袁咏琳
尘埃	袁咏琳
你不爱我了	袁咏琳
不求	杨培安
我相信	杨培安
黄河长江	杨培安
忘记你不如失去你	杨培安
痛也不说出口的我	杨培安
生死相随	杨培安
这该死的爱	杨培安
左边右边	杨培安
光辉岁月	杨培安
完美世界	杨培安
梦想从心开始	杨培安
梦想的翅膀	杨培安
信仰	杨培安
谢谢让我爱上你	杨培安
彩虹的尽头	杨培安
让全世界为我们加油	杨培安
最短的爱情	杨培安
梦在前方	杨培安
恋爱症候群	黄舒骏
马不停蹄的忧伤	黄舒骏
未央歌	黄舒骏
何德何能	黄舒骏
雁渡寒潭	黄舒骏
她以为她很美丽	黄舒骏
这就是爱	黄舒骏
男女之间	黄舒骏
不要只因为他亲吻了你	黄舒骏
思念进行曲	黄舒骏
我是谁	黄舒骏
少年狂想曲	黄舒骏
是否真心如我	黄舒骏
谈恋爱	黄舒骏
未来的街头	黄舒骏
窗	黄舒骏
为你疯狂	黄舒骏
爱如此徘徊	黄舒骏
天平座的女子	黄舒骏
我眼泪都笑了	刘力扬
一夜荡漾	刘力扬
给我个理由	刘力扬
我在人民广场吃炸鸡	刘力扬
Rain.希莱梅	刘力扬
属于你的歌	刘力扬
不朽	刘力扬
礼物	刘力扬
我就是这样(Mcyy)Remix	刘力扬
眼泪笑了	刘力扬
暂时不要多话	刘力扬
若即若离	刘力扬
一句一伤	刘力扬
想你的365天	李玟
叩叩	李玟
月光爱人	李玟
好心情	李玟
Baby对不起	李玟
你是我的Superman	李玟
美丽笨女人	李玟
真情人	李玟
颜色	李玟
自己	李玟
真想见到你	李玟
过完冬季	李玟
不潮不用花钱	李玟
魔镜	李玟
证据	杨乃文
星星堆满天	杨乃文
祝我幸福	杨乃文
我给的爱	杨乃文
静止	杨乃文
未接来电	杨乃文
忽然之间	杨乃文
花房姑娘	杨乃文
一个人	杨乃文
野百合也有春天	杨乃文
应该	杨乃文
逃兵	杨乃文
女爵	杨乃文
最初的地方	杨乃文
可惜爱	杨乃文
爱上你只是我的错	杨乃文
漂着	杨乃文
没有什么不同	曲婉婷
我的歌声里	曲婉婷
爱的勇气	曲婉婷
快活	曲婉婷
承认	曲婉婷
爱的海洋	曲婉婷
我为你歌唱	曲婉婷
最好的安排	曲婉婷
阳光下的我们	曲婉婷
我只在乎你	曲婉婷
今天	曲婉婷
其实都没有	杨宗纬
这一路走来	杨宗纬
空白格	杨宗纬
一次就好	杨宗纬
洋葱	杨宗纬
我变了	杨宗纬
越过山丘	杨宗纬
那个男人	杨宗纬
凉凉	杨宗纬
我们好像在哪见过	杨宗纬
初爱	杨宗纬
一场恋爱	杨宗纬
忘了我	杨宗纬
流浪记	杨宗纬
给未来的自己	杨宗纬
校园民谣创意混编	杨宗纬
听说爱情回来过	杨宗纬
为了遇见你	杨宗纬
为你我受冷风吹	杨宗纬
我是你的谁	黄立行
分开旅行	黄立行
无神论	黄立行
乖乖牌	黄立行
又不是真的爱	黄立行
礼物	黄立行
最后只好躺下来	黄立行
巴别塔	黄立行
你装酷,我想吐	黄立行
传奇	黄立行
冷水澡	黄立行
预言	黄立行
你身边	黄立行
遇见	孙燕姿
我怀念的	孙燕姿
开始懂了	孙燕姿
逆光	孙燕姿
绿光	孙燕姿
天黑黑	孙燕姿
我也很想他	孙燕姿
我不难过	孙燕姿
原来你什么都不要	孙燕姿
眼泪成诗	孙燕姿
雨天	孙燕姿
在，也不见	孙燕姿
克卜勒	孙燕姿
第一天	孙燕姿
半句再见	孙燕姿
尚好的青春	孙燕姿
直来直往	孙燕姿
月半小夜曲	李克勤
红日	李克勤
护花使者	李克勤
一生不变	李克勤
一生中最爱	李克勤
富士山下	李克勤
和你在一起	李克勤
遥远的她	李克勤
合久必婚	李克勤
没有你赢了世界又如何	李克勤
一生何求	李克勤
深深深	李克勤
相爱很难	李克勤
男人的歌	李克勤
我不会唱歌	李克勤
心动	陈洁仪
心如刀割	陈洁仪
喜欢你	陈洁仪
遗憾	陈洁仪
从前的我	陈洁仪
红色高跟鞋	陈洁仪
左右手	陈洁仪
爱不爱我	陈洁仪
至少还有你	陈洁仪
每一生都等你	陈洁仪
你把我灌醉	陈洁仪
入戏太深	陈洁仪
心会跟爱一起走	陈洁仪
醇酒醉影	陈洁仪
等了又等	陈洁仪
被风吹散的人们	陈洁仪
逆光飞翔	范逸臣
最近的距离，最远的旅行	范逸臣
黑白之间	范逸臣
国境之南	范逸臣
放生	范逸臣
不能没有你	范逸臣
无乐不作好时光	范逸臣
流浪	范逸臣
秀丽江山	范逸臣
我是谁	范逸臣
无缘	范逸臣
红色高跟鞋	蔡健雅
被驯服的象	蔡健雅
重来	蔡健雅
别找我麻烦	蔡健雅
陌生人	蔡健雅
无底洞	蔡健雅
思念是一种病	蔡健雅
紫	蔡健雅
停格	蔡健雅
下一次爱情来的时候	蔡健雅
空白格	蔡健雅
二手烟	蔡健雅
失语者	蔡健雅
双栖动物	蔡健雅
月满西楼	龚玥
父亲	龚玥
女儿情	龚玥
大悲咒	龚玥
梦里水乡	龚玥
枕着你的名字入眠	龚玥
枉凝眉	龚玥
牧羊曲	龚玥
遇上你是我的缘	龚玥
十送红军	龚玥
化蝶	龚玥
烟花三月	龚玥
母亲	龚玥
为了谁	龚玥
走西口	龚玥
晚秋	龚玥
月光下的凤尾竹	龚玥
驼铃	龚玥
红豆红	龚玥
梦醒了	袁惟仁
坦白	袁惟仁
想念	袁惟仁
旋木	袁惟仁
梦一场	袁惟仁
木吉他	袁惟仁
爱如潮水	张信哲
过火	张信哲
信仰	张信哲
别怕我伤心	张信哲
爱就一个字	张信哲
从开始到现在	张信哲
有一点动心	张信哲
太想爱你	张信哲
难以抗拒你容颜	张信哲
白月光	张信哲
爱你没错	张信哲
不要对他说	张信哲
宽容	张信哲
说谎	张信哲
背叛	张信哲
情非得已	张信哲
平凡之路	张信哲
兄弟抱一下	庞龙
你是我的玫瑰花	庞龙
两只蝴蝶	庞龙
幸福的两口子	庞龙
兄弟干杯	庞龙
家在东北	庞龙
杯水情歌	庞龙
我要抱着你	庞龙
吹眼睛	庞龙
星星照亮回家的路	庞龙
单身歌	庞龙
家的味道	庞龙
男人的累、男人的泪	庞龙
人在世上飘	庞龙
最亲爱亲爱的老婆	庞龙
校花	庞龙
爱情果	庞龙
万水千山总是情	汪明荃
京华春梦	汪明荃
用爱将心偷	汪明荃
鹊桥仙	汪明荃
爱你一世一生	汪明荃
扑蝶	汪明荃
今生不负爱	汪明荃
紫钗恨	汪明荃
潇洒走一回	汪明荃
采茶山歌	汪明荃
一生几多情份	汪明荃
伴你过一世	汪明荃
千王之王	汪明荃
爱你一生不够多	汪明荃
并蒂花	汪明荃
家乡	汪明荃
郎归晚	汪明荃
迎春花	汪明荃
追忆当日爱	汪明荃
不爱我就拉倒	周杰伦
告白气球	周杰伦
等你下课(with	周杰伦
稻香	周杰伦
晴天	周杰伦
七里香	周杰伦
青花瓷	周杰伦
简单爱	周杰伦
给我一首歌的时间	周杰伦
夜曲	周杰伦
彩虹	周杰伦
蒲公英的约定	周杰伦
搁浅	周杰伦
退后	周杰伦
听妈妈的话	周杰伦
烟花易冷	周杰伦
说好的幸福呢	周杰伦
一路向北	周杰伦
最长的电影	周杰伦
青藏高原	李娜
苦乐年华	李娜
南无阿弥陀佛	李娜
辘轳女人井	李娜
嫂子颂	李娜
篱笆墙的影子	李娜
苦篱笆	李娜
黄土高坡	李娜
女人是老虎	李娜
好人一生平安	李娜
信天游	李娜
人间终有真情在	李娜
你家在哪里	李娜
未了情	李娜
杜十娘	李娜
我热恋的故乡	李娜
说聊斋	李娜
人在旅途	李娜
武则天	李娜
大海	张雨生
一天到晚游泳的鱼	张雨生
最爱的人伤我最深	张雨生
天天想你	张雨生
还是朋友	张雨生
我期待	张雨生
我是一棵秋天的树	张雨生
烈火青春	张雨生
一生陪你走	张雨生
后知后觉	张雨生
执着	张雨生
和天一样高	张雨生
是否真的爱我	张雨生
如约而至	许嵩
明智之举	许嵩
有何不可	许嵩
清明雨上	许嵩
断桥残雪	许嵩
素颜	许嵩
庐州月	许嵩
灰色头像	许嵩
玫瑰花的葬礼	许嵩
幻听	许嵩
城府	许嵩
半城烟沙	许嵩
惊鸿一面	许嵩
多余的解释	许嵩
我乐意	许嵩
你若成风	许嵩
千百度	许嵩
山水之间	许嵩
雅俗共赏	许嵩
怎么说我不爱你	萧敬腾
王妃	萧敬腾
会痛的石头	萧敬腾
新不了情	萧敬腾
欲望反光	萧敬腾
阿飞的小蝴蝶	萧敬腾
我有多么喜欢你	萧敬腾
迷茫世代	萧敬腾
海芋恋	萧敬腾
我在人民广场吃炸鸡	萧敬腾
如果没有你	萧敬腾
王子的新衣	萧敬腾
让我为你唱情歌	萧敬腾
你会在哪呢？	萧敬腾
斗罗大陆	萧敬腾
我怀念的	萧敬腾
让我留在你身边	陈奕迅
我们	陈奕迅
不要说话	陈奕迅
十年	陈奕迅
渐渐	陈奕迅
红玫瑰	陈奕迅
好久不见	陈奕迅
富士山下	陈奕迅
陪你度过漫长岁月	陈奕迅
淘汰	陈奕迅
单车	陈奕迅
爱情转移	陈奕迅
浮夸	陈奕迅
阴天快乐	陈奕迅
K歌之王	陈奕迅
你的背包	陈奕迅
孤独患者	陈奕迅
最佳损友	陈奕迅
不让我的眼泪陪我过夜	齐秦
大约在冬季	齐秦
往事随风	齐秦
夜夜夜夜	齐秦
外面的世界	齐秦
无情的雨无情的你	齐秦
原来的我	齐秦
狼	齐秦
火柴天堂	齐秦
花祭	齐秦
张三的歌	齐秦
狂流	齐秦
如果云知道	齐秦
月亮代表我的心	齐秦
思念是一种病	齐秦
悬崖	齐秦
无情的雨	齐秦
冬雨	齐秦
心墙	郭静
下一个天亮	郭静
陪着我的时候想着她	郭静
在树上唱歌	郭静
我不想忘记你	郭静
每一天都不同	郭静
拥抱你的微笑	郭静
你的香气	郭静
可惜	郭静
别惹哭我	郭静
不药而愈	郭静
总算我们也爱过	郭静
离开	郭静
单身美好	郭静
我们都能幸福着	郭静
你眼中的我	郭静
往未来飞的客机	郭静
回忆的阁楼	郭静
信天游	杭天琪
唱脸谱	杭天琪
前门情思大碗茶	杭天琪
黄土高坡	杭天琪
走西口	杭天琪
我热恋的故乡	杭天琪
一个真实的故事	杭天琪
永远是朋友	杭天琪
黄河源头	杭天琪
黑头发飘起来	杭天琪
我依然爱你	杭天琪
打虎上山	杭天琪
月残花烛泪	杭天琪
心愿	杭天琪
红塔山下阿诗玛	杭天琪
西北风	杭天琪
给女儿的一封信	张杰
三生三世	张杰
只要平凡	张杰
逆战	张杰
我们都一样	张杰
仰望星空	张杰
剑心	张杰
明天过后	张杰
他不懂	张杰
着魔	张杰
勿忘心安	张杰
你就不要想起我	张杰
星辰	张杰
如歌	张杰
逆态度	张杰
好想大声说爱你	张杰
夜空中最亮的星	张杰
年轻的战场	张杰
爱一个人好难	苏永康
男人不该让女人流泪	苏永康
越吻越伤心	苏永康
那谁	苏永康
从不喜欢孤单一个	苏永康
相遇太早	苏永康
我不是爱过就算的人	苏永康
爱似狂潮	苏永康
让懂你的人爱你	苏永康
我为你伤心	苏永康
有人为你偷偷在哭	苏永康
性情中人	苏永康
喜帖街	苏永康
悲伤止步	苏永康
无法开口	苏永康
当有一天我老了	卢庚戌
我们生来就是孤独	卢庚戌
大鱼	卢庚戌
一生有你	卢庚戌
蝴蝶花	卢庚戌
未来的未来	卢庚戌
我的生命不过是温柔的疯狂	卢庚戌
没有人比我更爱你	卢庚戌
你是我的孤独	卢庚戌
九月	卢庚戌
时间的玫瑰	卢庚戌
借我一生	卢庚戌
致爱人	卢庚戌
每一次呼吸	卢庚戌
我知道	卢庚戌
我没有自己的名字	卢庚戌
情诗	卢庚戌
夜风	卢庚戌
老屋	卢庚戌
轻轻的告诉你	杨钰莹
心雨	杨钰莹
风含情水含笑	杨钰莹
我不想说	杨钰莹
我在春天等你	杨钰莹
心相印手牵手	杨钰莹
桃花运	杨钰莹
梦醒时分	杨钰莹
我悄悄地蒙上你的眼睛	杨钰莹
千千阙歌	杨钰莹
甜蜜蜜	杨钰莹
你若安好	杨钰莹
其实你不懂我的心	杨钰莹
天涯歌女	杨钰莹
轻轻地告诉你	杨钰莹
风中有朵雨做的云	杨钰莹
星辰大海是你	魏晨
封面恋人	魏晨
我为自己代言	魏晨
雨痕	魏晨
尘埃	魏晨
不变	魏晨
烈火神盾	魏晨
旅程	魏晨
白日梦想家	魏晨
天下有情人	魏晨
帽子戏法	魏晨
我们在改变	魏晨
没有到不了的地方	魏晨
复杂人生	魏晨
没那么简单	黄小琥
重来	黄小琥
顺其自然	黄小琥
伴	黄小琥
你把我灌醉	黄小琥
白天不懂夜的黑	黄小琥
新不了情	黄小琥
不只是朋友	黄小琥
该放手了	黄小琥
你怎么舍得我难过	黄小琥
突然的自我	黄小琥
心酸的成熟	黄小琥
你是我的眼	黄小琥
我的心里只有你没有他	黄小琥
放心不下	黄小琥
不该那么想你	黄小琥
我的歌声里	黄小琥
最爱的人	黄小琥
想太多	李玖哲
夏天	李玖哲
解脱	李玖哲
我会好好过	李玖哲
只牵你的手	李玖哲
不，完美	李玖哲
都怪我	李玖哲
死结	李玖哲
围墙	李玖哲
最后的那一天	李玖哲
别说	李玖哲
还会记得我吗	李玖哲
不爱了	李玖哲
爱不需要理由	李玖哲
做你的天	李玖哲
影子	李玖哲
Baby是我	李玖哲
白色恋人	游鸿明
爱我的人和我爱的人	游鸿明
下沙	游鸿明
孟婆汤	游鸿明
一天一万年	游鸿明
恋上一个人	游鸿明
诗人的眼泪	游鸿明
楼下那个女人	游鸿明
爱一回伤一回	游鸿明
恋上另一个人	游鸿明
五月的雪	游鸿明
地下铁	游鸿明
我们这里还有鱼	游鸿明
21个人	游鸿明
你连笑起来都不快乐	游鸿明
寻你	游鸿明
倦鸟余花	游鸿明
你微笑时好美	游鸿明
我的爱情被你烧成灰	游鸿明
最终信仰	尚雯婕
鹿	尚雯婕
木兰诗	尚雯婕
待我长发及腰	尚雯婕
生命的盛宴	尚雯婕
你怎么舍得我难过	尚雯婕
候鸟	尚雯婕
小星星	尚雯婕
女王驾到	尚雯婕
阿修罗	尚雯婕
时间的力量	尚雯婕
花火	尚雯婕
我很快乐	刘惜君
菩提偈	刘惜君
美丽心情	刘惜君
遥远的歌	刘惜君
怎么唱情歌	刘惜君
线	刘惜君
我只在乎你	刘惜君
醉里红尘	刘惜君
那时候的我	刘惜君
此时彼岸	刘惜君
不期而遇	刘惜君
贝壳风铃	刘惜君
漫步人生路	刘惜君
芬芳一生	刘惜君
爱别离	刘惜君
御龙品青梅	刘惜君
南海姑娘	刘惜君
原上草	刘惜君
亲爱的小孩	刘惜君
你要的爱	戴佩妮
怎样	戴佩妮
街角的祝福	戴佩妮
辛德瑞拉	戴佩妮
原谅我就是这样的女生	戴佩妮
一个人的行李	戴佩妮
爱疯了	戴佩妮
一念之间	戴佩妮
防...空洞	戴佩妮
路	戴佩妮
小小	戴佩妮
我们的故事	戴佩妮
贼	戴佩妮
无赖	戴佩妮
光着我的脚丫子	戴佩妮
两难	戴佩妮
多么想念你	戴佩妮
窗外	戴佩妮
爱不爱我	周晓鸥
无地自容	周晓鸥
无情的雨无情的你	周晓鸥
拥抱	周晓鸥
让爱从头	周晓鸥
粉墨人生	周晓鸥
如果我是梁山伯	周晓鸥
天空	周晓鸥
离开即归来	周晓鸥
爱情宣言	周晓鸥
流星无悔	周晓鸥
不再掩饰	周晓鸥
拯救	周晓鸥
旁边	周晓鸥
青春啊青春	周晓鸥
漫漫江湖游	周晓鸥
追梦人	凤飞飞
月朦胧	凤飞飞
掌声响起	凤飞飞
爱你在心口难开	凤飞飞
我是一片云	凤飞飞
往事难追忆	凤飞飞
潇洒的走	凤飞飞
春风吻上我的脸	凤飞飞
天涯歌女	凤飞飞
蝶恋花	凤飞飞
莫让红颜守空尘	凤飞飞
姑娘十八一朵花	凤飞飞
片片枫叶片片情	凤飞飞
南屏晚钟	凤飞飞
今宵多珍重	凤飞飞
绿岛小夜曲	凤飞飞
知己	凤飞飞
相思河畔	凤飞飞
往事如烟	凤飞飞
红颜劫	姚贝娜
鱼	姚贝娜
战争世界	姚贝娜
随它吧	姚贝娜
时间都去哪儿了	姚贝娜
矜持	姚贝娜
画情	姚贝娜
菩萨蛮	姚贝娜
至少还有你	姚贝娜
心火	姚贝娜
也许明天	姚贝娜
惊鸿舞	姚贝娜
御龙吟	姚贝娜
采莲	姚贝娜
如果没有你	姚贝娜
金缕衣	姚贝娜
天耀中华	姚贝娜
好心分手	卢巧音
三角志	卢巧音
落地开花	卢巧音
垃圾	卢巧音
喜欢恋爱	卢巧音
逆插玫瑰	卢巧音
至少走的比你早	卢巧音
花奴	卢巧音
深蓝	卢巧音
天佑我们	卢巧音
去你的婚礼	卢巧音
乱世佳人	卢巧音
佛洛伊德爱上林夕	卢巧音
命犯桃花	卢巧音
情网	任静
知心爱人	任静
无情相思无情泪	任静
真是太傻	任静
无望的痴情	任静
错误的爱	任静
只好把你遗忘	任静
你是幸福的	任静
叫我去问谁	任静
孤寂的心	任静
不再梦见你	任静
风飞沙	任静
观音菩萨在心中	任静
爱情一百年	任静
爱的沧桑	任静
雨中恋	任静
爱的誓言	任静
我今生最爱的人	任静
当你老了	任静
当你孤单你会想起谁	张栋梁
北极星的眼泪	张栋梁
小乌龟	张栋梁
痛彻心扉	张栋梁
错了再错	张栋梁
只因为你	张栋梁
王子	张栋梁
就微笑了	张栋梁
黄昏	张栋梁
寂寞边界	张栋梁
说你也一样爱着我	张栋梁
别再惊动爱情	张栋梁
错爱	张栋梁
怎么会哭	张栋梁
沉默的瞬间	张栋梁
陌路	张栋梁
世界上最爱你的人	张栋梁
爱你胜过自己	张栋梁
新歌试唱	张栋梁
爸爸妈妈	王蓉
哎呀	王蓉
小鸡小鸡	王蓉
我不是黄蓉	王蓉
坏姐姐	王蓉
要抱抱	王蓉
好乐Day	王蓉
芙蓉姐夫	王蓉
火了火了火	王蓉
般若波罗蜜多心经	王蓉
水煮鱼	王蓉
抖抖傲	王蓉
红烧肉	王蓉
鲨鱼鲨鱼	王蓉
啪啪S舞	王蓉
加倍	王蓉
爱似神仙	王蓉
三生三世	王蓉
我不是美女	王蓉
让一切随风	钟镇涛
只要你过得比我好	钟镇涛
大海	钟镇涛
漫漫人生路	钟镇涛
梅花烙	钟镇涛
曾经	钟镇涛
红叶…斜落我心寂寞时	钟镇涛
爱得忘了自己	钟镇涛
一段情	谭咏麟
无言感激	钟镇涛
其实我没有那么坚强	钟镇涛
香肠蚊帐机关枪	钟镇涛
飘	钟镇涛
一个错误	钟镇涛
等你	钟镇涛
让我坦荡荡	钟镇涛
爱情鸟	林依轮
透过开满鲜花的月亮	林依轮
火火的歌谣	林依轮
向快乐出发	林依轮
步步高	林依轮
爱在2000	林依轮
快乐老家	林依轮
锣鼓	林依轮
月圆花好	林依轮
靠近你，温暖我	林依轮
我只想好好爱你	林依轮
北京童谣	林依轮
最后的温柔	林依轮
心动	林依轮
美丽的传说	林依轮
月亮湾	林依轮
一路同行	林依轮
领悟	孟楠
痒	孟楠
软肋	孟楠
白月光	孟楠
我只有我	孟楠
别让爱情走了样	孟楠
痒2018	孟楠
爱情不过那么回事	孟楠
痒（更痒）	孟楠
硬邦邦	孟楠
一起摇摆	孟楠
爱	孟楠
问	孟楠
爱上你不可惜	孟楠
迟到	孟楠
握住我的手	孟楠
弯弯的月亮	孟楠
归来	满江
飞鸟	满江
我们之间	满江
裙角飞扬	满江
奇迹	满江
心碎北京	满江
最后的温柔	满江
烟火	满江
黑暗中舞蹈	满江
你是春风我是雨	满江
当我们聊到未来的时候，未来就过去了	满江
中华诵	满江
最美的时光	满江
阳光下	满江
等	满江
四舍五入	满江
恋爱中的城市	满江
多情的土地	廖昌永
天边	廖昌永
父亲的草原母亲的河	廖昌永
那就是我	廖昌永
我爱你，中国	廖昌永
我和我的祖国	廖昌永
月满西楼	廖昌永
莫斯科郊外的晚上	廖昌永
共和国之恋	廖昌永
山楂树	廖昌永
在银色月光下	廖昌永
草原夜色美	廖昌永
映山红	廖昌永
驼铃	廖昌永
小路	廖昌永
老师我总是想起你	廖昌永
红梅花儿开	廖昌永
海恋	廖昌永
江河万古流	廖昌永
朋友别哭	吕方
老情歌	吕方
多爱你一天	吕方
流浪花	吕方
爱一回伤一回	吕方
弯弯的月亮	吕方
每段路	吕方
听不到的说话	吕方
只想遇到一个人	吕方
一帘幽梦	吕方
雪山飞狐	吕方
天老情未老	吕方
你令我快乐过	吕方
请你跟我走	吕方
城里的月光	吕方
爱的路上千万里	吕方
只因我太痴	吕方
最重要的决定	范玮琪
最初的梦想	范玮琪
一个像夏天一个像秋天	范玮琪
可不可以不勇敢	范玮琪
是非题	范玮琪
到不了	范玮琪
那些花儿	范玮琪
最亲爱的你	范玮琪
我们的纪念日	范玮琪
黑白配	范玮琪
启程	范玮琪
悄悄告诉你	范玮琪
一颗心的距离	范玮琪
蒲公英	范玮琪
我终于失去了你	范玮琪
没那么爱他	范玮琪
很久很久以后	范玮琪
动物森林	范玮琪
恋曲1990	罗大佑
你的样子	罗大佑
光阴的故事	罗大佑
童年	罗大佑
皇后大道东	罗大佑
沧海一声笑	罗大佑
野百合也有春天	罗大佑
穿过你的黑发的我的手	罗大佑
东方之珠	罗大佑
爱的箴言	罗大佑
我是不是该安静的走开	郭富城
对你爱不完	郭富城
动起来	郭富城
爱的呼唤	郭富城
狂野之城	郭富城
唱这歌	郭富城
听风的歌	郭富城
伤心的话留到明天再说	郭富城
到底有谁能够告诉我	郭富城
风里密码	郭富城
无忌	郭富城
我想偷偷对你说我爱你	郭富城
就是孙悟空	郭富城
永远爱不完	郭富城
把所有的爱都留给你	郭富城
铁幕诱惑	郭富城
我要给你全部的爱	郭富城
乡恋	李谷一
难忘今宵	李谷一
绒花	李谷一
边疆的泉水清又纯	李谷一
年轻的朋友来相会	李谷一
知音	李谷一
我和我的祖国	李谷一
妹妹找哥泪花流	李谷一
浏阳河	李谷一
前门情思大碗茶	李谷一
一条大河	李谷一
心中的玫瑰	李谷一
花儿为什么这样红	李谷一
弹起我心爱的土琵琶	李谷一
我爱你中国	李谷一
刘海砍樵	李谷一
故乡是北京	李谷一
长大后我就成了你	李谷一
我有多么喜欢你	林宥嘉
成全	林宥嘉
说谎	林宥嘉
浪费	林宥嘉
突然想起你	林宥嘉
残酷月光	林宥嘉
致姗姗来迟的你	林宥嘉
想自由	林宥嘉
我爱的人	林宥嘉
心酸	林宥嘉
船	林宥嘉
我只在乎你	林宥嘉
眼色	林宥嘉
吻得太逼真	林宥嘉
再别康桥	林宥嘉
我乘着风飞过来	洪辰
天高地厚	洪辰
勇往直前	洪辰
恋爱咒语	洪辰
不生气了，好吗	洪辰
无法原谅	洪辰
至少还有你	洪辰
离歌	洪辰
狐狸叫	洪辰
如果这就是爱情	洪辰
狼	洪辰
千面	陈志朋
诱惑YOHO	陈志朋
祝你一路顺风	陈志朋
爱	陈志朋
红蜻蜓	陈志朋
无路可退	陈志朋
伤心的人别听慢歌	陈志朋
莫妮卡	陈志朋
舍不得	陈志朋
青苹果乐园	陈志朋
他和她	陈志朋
叫你一声	陈志朋
共同渡过	陈志朋
女人花	陈志朋
孤独成瘾	陈志朋
好聚好散	陈志朋
记住你的香	陈志朋
你的城市你的故事	陈志朋
放心去飞	陈志朋
分手后不要做朋友	梁文音
爱一直存在	梁文音
最幸福的事	梁文音
满满	梁文音
很久很久以后	梁文音
我不是你想像那么勇敢	梁文音
还好	梁文音
不期而遇	梁文音
还是朋友	梁文音
最亲爱的	梁文音
三个愿望	梁文音
情人知己	梁文音
副驾驶座的风景	梁文音
薄荷与指甲剪	梁文音
可以不爱了	梁文音
转折	梁文音
和平分手	梁文音
我们都别哭	梁文音
明天你是否依然爱我	童安格
其实你不懂我的心	童安格
把根留住	童安格
借我一点爱	童安格
让生命等候	童安格
耶利亚女郎	童安格
花瓣雨	童安格
爱与哀愁	童安格
一世情缘	童安格
忘不了	童安格
不必太在意	童安格
谢谢最深爱的你	童安格
游戏人间	童安格
别把我的心带走	童安格
梦开始的地方	童安格
等我一起入梦	童安格
一天一点爱恋	童安格
雪候鸟	熊天平
愚人码头	熊天平
火柴天堂	熊天平
爱情多恼河	熊天平
夜夜夜夜	熊天平
大雨带我逃亡	熊天平
心有灵犀	熊天平
相思无解	熊天平
一个人流浪	熊天平
最后还是会	熊天平
爱情电影	熊天平
月亮森林	熊天平
我都在乎	熊天平
记事本	陈慧琳
不如跳舞	陈慧琳
花花宇宙	陈慧琳
都是你的错	陈慧琳
希望	陈慧琳
打字机	陈慧琳
不得了	陈慧琳
今生你作伴	陈慧琳
对你太在乎	陈慧琳
心不设防	陈慧琳
有时寂寞	陈慧琳
再生花	陈慧琳
她一定很爱你	陈慧琳
她比我丑	陈慧琳
我不够爱你	陈慧琳
再见北极雪	陈慧琳
蝴蝶泉边	黄雅莉
田园香	黄雅莉
给眼泪一点时间	黄雅莉
我的光	黄雅莉
曾经	黄雅莉
丑八怪	黄雅莉
前任女友	黄雅莉
心跳着	黄雅莉
年轮	黄雅莉
相爱的人都等在那地方	黄雅莉
不一定快乐	黄雅莉
黄雅莉	黄雅莉
再见面的时候	黄雅莉
远在咫尺近在天边	黄雅莉
想你笑	黄雅莉
小星星	黄雅莉
喵喵歌	黄雅莉
时空旅人	黄雅莉
一爱难求	徐佳莹
失落沙洲	徐佳莹
身骑白马	徐佳莹
最初的记忆	徐佳莹
突然好想你	徐佳莹
不醉不会	徐佳莹
修炼爱情	徐佳莹
我们的十年	徐佳莹
浪费	徐佳莹
不要再孤单	徐佳莹
莉莉安	徐佳莹
远走高飞	徐佳莹
我好想你	徐佳莹
湫兮如风	徐佳莹
大雨将至	徐佳莹
喜欢你	徐佳莹
不痛	徐佳莹
当我找到了你	徐佳莹
斯琴高丽的伤心	斯琴高丽
犯错	斯琴高丽
猜	斯琴高丽
观音手	斯琴高丽
斯琴高丽伤心	斯琴高丽
上上签	斯琴高丽
好想你	斯琴高丽
爱是你给我的伤	斯琴高丽
爱上你很快乐	斯琴高丽
我也只是个女人	斯琴高丽
斯琴高丽的开心	斯琴高丽
分手的那天	斯琴高丽
爱上你	斯琴高丽
情不悔	斯琴高丽
当我傻瓜	斯琴高丽
假如爱能重来过	斯琴高丽
我只在乎你	邓丽君
漫步人生路	邓丽君
甜蜜蜜	邓丽君
小城故事	邓丽君
在水一方	邓丽君
月亮代表我的心	邓丽君
恰似你的温柔	邓丽君
你怎么说	邓丽君
千言万语	邓丽君
何日君再来	邓丽君
夜来香	邓丽君
但愿人长久	邓丽君
酒醉的探戈	邓丽君
再见！我的爱人	邓丽君
阿里山的姑娘	邓丽君
北国之春	邓丽君
山茶花	邓丽君
独上西楼	邓丽君
你怎么舍得我难过	黄品源
海浪	黄品源
小薇	黄品源
狠不下心	黄品源
孤单爱情海	黄品源
我该用什么样的心来对你	黄品源
永远有多远	黄品源
那么爱你为什么	黄品源
你怎么会这样离开我	黄品源
情非得已	黄品源
浪花一朵朵	黄品源
不想说再见	黄品源
你怎么舍得我难过(Live)	黄品源
就算痛的是我	黄品源
谁能让时间倒转	黄品源
父亲写的散文诗	许飞
我要的飞翔	许飞
如果有个直达天堂的电梯	许飞
寻水的鱼	许飞
左半边翅膀	许飞
不说再见	许飞
突然好想你	许飞
那年夏天	许飞
我们终究会牵手旅行	许飞
淡淡的歌	许飞
时光遐想	许飞
我设计一万种方式遇见你	许飞
慢慢的我	许飞
他在那里站岗	许飞
新兵日记	许飞
梨花又开放	许飞
我们要走遍所有最浪漫的地方	许飞
许愿树	许飞
故乡的云	许飞
潮湿的心	卓依婷
爱拼才会赢	卓依婷
萍聚	卓依婷
东南西北风	卓依婷
迟来的爱	卓依婷
明天会更好	卓依婷
捉泥鳅	卓依婷
心雨	卓依婷
谢谢你一直爱着我	卓依婷
爱情一阵风	卓依婷
曾经心疼	卓依婷
长相依	卓依婷
杜十娘	卓依婷
爱江山更爱美人	卓依婷
童年	卓依婷
风中有朵雨做的云	卓依婷
真的好想你	卓依婷
梦醒时分	卓依婷
爱，是一条河流	李泉
我要我们在一起	李泉
一生所爱	李泉
想爱你	李泉
秋意浓	李泉
爱的箴言	李泉
走钢索的人	李泉
哪怕我很小	李泉
眼色	李泉
拥有	李泉
哭了	李泉
时间飞了	李泉
你的眼神	蔡琴
被遗忘的时光	蔡琴
恰似你的温柔	蔡琴
渡口	蔡琴
张三的歌	蔡琴
把悲伤留给自己	蔡琴
南屏晚钟	蔡琴
读你	蔡琴
往事只能回味	蔡琴
明月千里寄相思	蔡琴
明天你是否依然爱我	蔡琴
月满西楼	蔡琴
绿岛小夜曲	蔡琴
不了情	蔡琴
夜来香	蔡琴
相思河畔	蔡琴
其实你不懂我的心	蔡琴
外婆的澎湖湾	蔡琴
情人的眼泪	蔡琴
黄昏	周传雄
冬天的秘密	周传雄
寂寞沙洲冷	周传雄
关不上的窗	周传雄
我的心太乱	周传雄
男人海洋	周传雄
有没有一首歌会让你想起我	周传雄
蓝色土耳其	周传雄
青花	周传雄
记事本	周传雄
弱水三千	周传雄
出卖	周传雄
花香	周传雄
告白气球	周传雄
末班车	周传雄
忘记	周传雄
吉普赛情人	周传雄
樱吹雪	周传雄
暖风	周传雄
让泪化作相思雨	樊桐舟
你是我一生最爱的人	樊桐舟
最远的你是我最近的爱	樊桐舟
语花蝶	樊桐舟
男人的好	樊桐舟
不让我的眼泪陪我过夜	樊桐舟
雪花	樊桐舟
万水千山总是爱	樊桐舟
擦肩而过	樊桐舟
分飞	樊桐舟
为爱伤心为你痛	樊桐舟
无情的雨无情的你	樊桐舟
情为何物	樊桐舟
别让我一个人醉	樊桐舟
两只蝴蝶	樊桐舟
朋友别哭	樊桐舟
曾经最美	樊桐舟
一生爱你千百回	樊桐舟
寂寞沙洲冷	樊桐舟
分飞	徐怀钰
踏浪	徐怀钰
我是女生	徐怀钰
叮咚	徐怀钰
向前冲	徐怀钰
温习	徐怀钰
水晶	徐怀钰
友情卡片	徐怀钰
怪兽	徐怀钰
爱像一场重感冒	徐怀钰
天使	徐怀钰
心中的遗憾	徐怀钰
乱了	徐怀钰
谁不乖	徐怀钰
誓言	徐怀钰
大家来恋爱	徐怀钰
千里之外	费玉清
南屏晚钟	费玉清
上海滩	费玉清
梦驼铃	费玉清
昨夜小楼又东风	费玉清
涛声依旧	费玉清
一帘幽梦	费玉清
成都	费玉清
新鸳鸯蝴蝶梦	费玉清
在水一方	费玉清
爱的供养	费玉清
真的好想你	费玉清
大王带我来巡山	费玉清
卷珠帘	费玉清
小城故事	费玉清
青花瓷	费玉清
多情总为无情伤	费玉清
星星点灯	郑智化
水手	郑智化
游戏人间	郑智化
别哭，我最爱的人	郑智化
三十三块	郑智化
你的生日	郑智化
堕落天使	郑智化
年轻时代	郑智化
我这样的男人	郑智化
麻花辫子	郑智化
中产阶级	郑智化
面子问题	郑智化
沉默的羔羊	郑智化
用我一辈子去忘记	郑智化
单身逃亡	郑智化
落泪的戏子	郑智化
大同世界	郑智化
未婚爸爸	郑智化
小草	郑智化
如果有来生	谭维维
为了你	谭维维
乌兰巴托的夜	谭维维
华阴老腔一声喊	谭维维
三十岁的女人	谭维维
缘分一道桥	谭维维
开门见山	谭维维
夜空中最亮的星	谭维维
爱到底	谭维维
给你一点颜色	谭维维
爱难脱身	谭维维
一生所爱	谭维维
要死就一定要死在你手里	谭维维
绅士	谭维维
谭某某	谭维维
陌上花开	谭维维
慢慢喜欢你	莫文蔚
忽然之间	莫文蔚
盛夏的果实	莫文蔚
阴天	莫文蔚
电台情歌	莫文蔚
如果没有你	莫文蔚
他不爱我	莫文蔚
扶摇	莫文蔚
半生缘（我们在这里相遇）	莫文蔚
广岛之恋	莫文蔚
外面的世界	莫文蔚
一生所爱	莫文蔚
如初之光	莫文蔚
爱	莫文蔚
爱情	莫文蔚
不待续	莫文蔚
暗香	沙宝亮
最初的信仰	沙宝亮
男人好难	沙宝亮
友情卡片	沙宝亮
野子	沙宝亮
飘	沙宝亮
女人的选择	沙宝亮
往事随风	沙宝亮
秋意浓	沙宝亮
阆中之恋	沙宝亮
爱的人	沙宝亮
让每个人都心碎	沙宝亮
多瑙河畔	沙宝亮
其实你不懂我的心	沙宝亮
爱你在心口难开	沙宝亮
送别	沙宝亮
再见	张震岳
爱的初体验	张震岳
爱我别走	张震岳
差不多先生	张震岳
小宇	张震岳
自由	张震岳
就让这首歌	张震岳
路口	张震岳
凡人歌	张震岳
不要说爱我	张震岳
两手空空	张震岳
思念是一种病	张震岳
很难	张震岳
分手吧	张震岳
酒干倘卖无	张震岳
嗨嗨人生	张震岳
我家门前有大海	张震岳
抱着你	张震岳
我想更懂你	潘玮柏
不得不爱	潘玮柏
反转地球	潘玮柏
爱上未来的你	潘玮柏
亲爱的	潘玮柏
双人舞	潘玮柏
我的麦克风	潘玮柏
壁虎漫步	潘玮柏
路太弯	潘玮柏
我对天空说	潘玮柏
稀罕没理由	潘玮柏
转机	潘玮柏
你要的全拿走	胡彦斌
爱不得	胡彦斌
月光	胡彦斌
还魂门	胡彦斌
为你我受冷风吹	胡彦斌
红颜	胡彦斌
决别诗	胡彦斌
男人KTV	胡彦斌
在一起	胡彦斌
蝴蝶	胡彦斌
慢慢	胡彦斌
快意江湖	胡彦斌
包袱	胡彦斌
山丘	胡彦斌
潇湘雨	胡彦斌
当爱已成往事	胡彦斌
味道	胡彦斌
江湖再见	胡彦斌
陪我看日出	蔡淳佳
等一个晴天	蔡淳佳
依恋	蔡淳佳
庆幸有你爱我	蔡淳佳
对不起我爱你	蔡淳佳
眼里眉间	蔡淳佳
回到最初	蔡淳佳
要幸福啊	蔡淳佳
南屏晚钟	蔡淳佳
前座后座	蔡淳佳
风铃	蔡淳佳
玻璃	蔡淳佳
隐形纪念	蔡淳佳
爱如潮水	蔡淳佳
回家的路	蔡淳佳
左右为难	蔡淳佳
檐前雨	蔡淳佳
有一天我会	蔡淳佳
说句心里话	阎维文
小白杨	阎维文
想家的时候	阎维文
母亲	阎维文
人间第一情	阎维文
红星照我去战斗	阎维文
强军战歌	阎维文
一二三四歌	阎维文
十五的月亮	阎维文
乌苏里船歌	阎维文
敖包相会	阎维文
打靶归来	阎维文
我爱五指山，我爱万泉河	阎维文
送别	阎维文
篱笆墙的影子	阎维文
军人本色	阎维文
什么也不说	阎维文
人说山西好风光	阎维文
逝去的爱	欧阳菲菲
感恩的心	欧阳菲菲
吻到心伤透	欧阳菲菲
热情的沙漠	欧阳菲菲
爱的路上我和你	欧阳菲菲
的士高皇后	欧阳菲菲
出境入境	欧阳菲菲
不是因为寂寞才想你	欧阳菲菲
雨中徘徊	欧阳菲菲
寂寞的高跟鞋	欧阳菲菲
心声	欧阳菲菲
今夜我仍在想你	欧阳菲菲
追忆	欧阳菲菲
尽在不言中	欧阳菲菲
你想爱谁就爱谁	欧阳菲菲
不能没有你	欧阳菲菲
火鸟	欧阳菲菲
再见午夜	欧阳菲菲
有没有人曾告诉你	陈楚生
有没有人告诉你	陈楚生
风起时，想你	陈楚生
瘾	陈楚生
那个远方	陈楚生
一场游戏一场梦	陈楚生
我知道你离我不远	陈楚生
山楂花	陈楚生
姑娘	陈楚生
渺小	陈楚生
一个人的冬天	陈楚生
思念一个荒废的名字	陈楚生
相忘于江湖	陈楚生
不如怀念	陈楚生
岁月神偷	陈楚生
经过	陈楚生
一个人唱情歌	陈楚生
讲不出再见	谭咏麟
一生中最爱	谭咏麟
朋友	谭咏麟
再见亦是泪	谭咏麟
爱在深秋	谭咏麟
爱多一次痛多一次	谭咏麟
披着羊皮的狼	谭咏麟
难舍难分	谭咏麟
一生何求	谭咏麟
水中花	谭咏麟
情缘巴士站	谭咏麟
千千阙歌	谭咏麟
让一切随风	谭咏麟
爱情陷阱	谭咏麟
半梦半醒	谭咏麟
捕风的汉子	谭咏麟
也曾相识	谭咏麟
雨夜的浪漫	谭咏麟
如风往事	卢冠廷
再回首	卢冠廷
一生所爱	卢冠廷
浪子心声	卢冠廷
陪着你走	卢冠廷
世事何曾是绝对	卢冠廷
凭著爱	卢冠廷
赌神	卢冠廷
风继续吹	卢冠廷
大话西游	卢冠廷
我在那一角落患过伤风	冯曦妤
避风港	冯曦妤
幸运儿	冯曦妤
再见警察	冯曦妤
如果…阳光	冯曦妤
不做你的情人	冯曦妤
阳光．雨	冯曦妤
小伤口	冯曦妤
微不足道的小事是我还爱着你	张磊
虎口脱险	张磊
南山南	张磊
异乡人	张磊
暖人	张磊
梦一场	张磊
人生是一次热血的流浪	张磊
因为一个人	张磊
旅行	张磊
一念天堂	张磊
路远	张磊
幸福一家人	张磊
相爱恨晚	张磊
后来你好吗	张磊
那么骄傲	张磊
远方	张磊
一次就好	张磊
切歌之王	张磊
文艺少年	张磊
独角戏	许茹芸
如果云知道	许茹芸
泪海	许茹芸
不爱我放了我	许茹芸
突然想爱你	许茹芸
美梦成真	许茹芸
好听	许茹芸
你的眼睛	许茹芸
我有一帘幽梦	许茹芸
为你我受冷风吹	许茹芸
一帘幽梦	许茹芸
独上西楼	许茹芸
日光机场	许茹芸
梅花	许茹芸
你怎么舍得伤害我	许茹芸
在水一方	许茹芸
男人女人	许茹芸
你啊你啊	魏如萱
香格里拉	魏如萱
晚安晚安	魏如萱
星期三或礼拜三	魏如萱
还是要相信爱情啊混蛋们	魏如萱
我爸的笔	魏如萱
小鱼	魏如萱
末路狂花	魏如萱
好吗好吗	魏如萱
我们	魏如萱
女人经痛时	魏如萱
买你	魏如萱
爱的季节	魏如萱
一起去旅行	魏如萱
房间	魏如萱
世界末日的某个角落	魏如萱
我喜欢上你时的内心活动	陈绮贞
旅行的意义	陈绮贞
还是会寂寞	陈绮贞
私奔到月球	陈绮贞
告诉我	陈绮贞
天天想你	陈绮贞
太聪明	陈绮贞
九份的咖啡店	陈绮贞
小步舞曲	陈绮贞
讨厌喜欢你	陈绮贞
就算全世界与我为敌	陈绮贞
微凉的你	陈绮贞
我的骄傲无可救药	陈绮贞
我亲爱的偏执狂	陈绮贞
小尘埃	陈绮贞
送别	陈绮贞
躺在你的衣柜	陈绮贞
蝴蝶泉边	牛欣欣
灯塔	牛欣欣
还能孩子多久	牛欣欣
梦.计划	牛欣欣
莫斯科没有眼泪	牛欣欣
舞公主	牛欣欣
梦的主场	牛欣欣
没有什么不同	牛欣欣
红色竹蜻蜓	牛欣欣
下一秒	牛欣欣
我的未来式	牛欣欣
有梦的天空	牛欣欣
吃葡萄不吐葡萄皮	牛欣欣
谁说女子不如男	牛欣欣
魔幻水晶	牛欣欣
天使在唱歌	牛欣欣
在地球的最后一天	牛欣欣
重整河山待后生	牛欣欣
千千阙歌	陈慧娴
人生何处不相逢	陈慧娴
飘雪	陈慧娴
逝去的诺言	陈慧娴
傻女	陈慧娴
归来吧	陈慧娴
孤单背影	陈慧娴
夜机	陈慧娴
让一切随风	陈慧娴
红茶馆	陈慧娴
月半小夜曲	陈慧娴
你怎么舍得我难过	陈慧娴
跳舞街	陈慧娴
月亮	陈慧娴
玻璃窗的爱	陈慧娴
再回首	姜育恒
别让我一个人醉	姜育恒
跟往事干杯	姜育恒
驿动的心	姜育恒
女人的选择	姜育恒
梅花三弄	姜育恒
多年以后	姜育恒
情难枕	姜育恒
其实我真的很在乎	姜育恒
往事只能回味	姜育恒
像我这样的人	姜育恒
从不后悔爱上你	姜育恒
一帘幽梦	姜育恒
一世情缘	姜育恒
哭过	姜育恒
我是个很容易掏心的人	姜育恒
在雨中	姜育恒
爱我，你怕了吗	姜育恒
谁	谢雨欣
第三天	谢雨欣
等你爱我	谢雨欣
天仙子	谢雨欣
将爱情进行到底	谢雨欣
老公老公我爱你	谢雨欣
仰望	谢雨欣
步步高	谢雨欣
爱是怎样炼成的	谢雨欣
生命如歌	谢雨欣
穿裙子的季节	谢雨欣
遥望	谢雨欣
新年快乐	谢雨欣
再见的人终会再见面	谢雨欣
伤了心	谢雨欣
天上的云我的心	谢雨欣
花街	谢雨欣
雨花	谢雨欣
珊瑚海	梁心颐
不敢哭	梁心颐
不遇见	梁心颐
小树	梁心颐
蛇舞	梁心颐
碎片	梁心颐
比较大的大提琴	梁心颐
因为你	梁心颐
我没有	梁心颐
滴答	梁心颐
梦织花园	梁心颐
胡椒与盐	梁心颐
味道	辛晓琪
领悟	辛晓琪
俩俩相忘	辛晓琪
深情相拥	辛晓琪
亲爱的小孩	辛晓琪
深情难了	辛晓琪
走过	辛晓琪
迷途	辛晓琪
空窗	辛晓琪
至少还有你	辛晓琪
我也会爱上别人的	辛晓琪
别问旧伤口	辛晓琪
原来的我	辛晓琪
相信爱情	辛晓琪
请不要对我说sorry	何洁
小永远	何洁
越伤越爱	何洁
你是我的风景	何洁
有没有	何洁
不可能的人	何洁
身不由己	何洁
希望	何洁
我只剩下自己	何洁
是不是爱情	何洁
好想你	何洁
小情书	何洁
我多么怀念	何洁
请别再爱我	何洁
双倍心跳	何洁
燃烧吧青春	何洁
断执念	何洁
偏爱	张芸京
春泥	张芸京
情人结	张芸京
破天荒	张芸京
留心	张芸京
青花	张芸京
黑裙子	张芸京
我不爱你了	张芸京
相反的我	张芸京
不再联络	张芸京
我没有疯	张芸京
让我照顾你	张芸京
怎么开始忘了	张芸京
爱情选项	张芸京
痛也爱你	张芸京
你是唯一	张芸京
坏了	张芸京
答案	杨坤
空城	杨坤
无所谓	杨坤
路灯下的小姑娘	杨坤
牧马人	杨坤
我没你想的那么坚强	杨坤
那一天	杨坤
真的很在乎	杨坤
穷浪漫	杨坤
远走高飞	杨坤
月亮可以代表我的心	杨坤
站台2010	杨坤
要死就一定要死在你手里	杨坤
里约热内卢	杨坤
直到世界尽头	杨坤
画心	杨坤
今夜二十岁	杨坤
我比从前更寂寞	杨坤
两个人的世界	杨坤
我可以	蔡旻佑
你看不到的天空	蔡旻佑
寂寞，好了	蔡旻佑
我想要说	蔡旻佑
好不好	蔡旻佑
怎么爱你都不够	蔡旻佑
我想我可以	蔡旻佑
小乖乖	蔡旻佑
翻不完的夏天	蔡旻佑
谁知道	蔡旻佑
最安静的话	蔡旻佑
发光的简讯	蔡旻佑
假男友	蔡旻佑
2人	蔡旻佑
最烂的我们	蔡旻佑
走	蔡旻佑
约定	蔡旻佑
我的宝贝	蔡旻佑
后来	刘若英
原来你也在这里	刘若英
当爱在靠近	刘若英
成全	刘若英
为爱痴狂	刘若英
很爱很爱你	刘若英
一辈子的孤单	刘若英
我们没有在一起	刘若英
亲爱的路人	刘若英
听说	刘若英
十年	刘若英
幸福不是情歌	刘若英
我曾爱过一个男孩	刘若英
幸福就是	刘若英
同桌的你	刘若英
把悲伤留给自己	刘若英
知道不知道	刘若英
我们的歌	王力宏
大城小爱	王力宏
你不知道的事	王力宏
改变自己	王力宏
依然爱你	王力宏
心跳	王力宏
唯一	王力宏
春雨里洗过的太阳	王力宏
爱的就是你	王力宏
南京，南京	王力宏
花田错	王力宏
你是我心内的一首歌	王力宏
需要人陪	王力宏
心中的日月	王力宏
落叶归根	王力宏
天亮了	韩红
天路	韩红
青藏高原	韩红
那片海	韩红
美丽的神话	韩红
绒花	韩红
一个人	韩红
魔鬼中的天使	韩红
映山红	韩红
家乡	韩红
梨花又开放	韩红
往事随风	韩红
天地	韩红
回到拉萨	韩红
天之大	韩红
橄榄树	韩红
雁南飞	韩红
无人岛	周笔畅
最美的期待	周笔畅
岁月神偷	周笔畅
谁动了我的琴弦	周笔畅
笔记	周笔畅
我选择喜欢你	周笔畅
对嘴	周笔畅
注定	周笔畅
若不是那次夜空	周笔畅
用尽我的一切奔向你	周笔畅
解脱	周笔畅
大家一起喜羊羊	周笔畅
说散就散	周笔畅
一周年	周笔畅
密友	周笔畅
片羽时光	周笔畅
别忘了	周笔畅
不痛	周笔畅
幸福出发	钟欣潼
你不会懂	钟欣潼
你看得见吗	钟欣潼
放低过去	钟欣潼
桐花	钟欣潼
全部都给你	钟欣潼
最美好的未来	钟欣潼
星星的眼泪	钟欣潼
你会幸福的	钟欣潼
一生一世	钟欣潼
非爱不可	钟欣潼
一辈子	钟欣潼
把悲伤留给自己	钟欣潼
心多	钟欣潼
天后站出发	钟欣潼
惯性冬眠	钟欣潼
最熟悉的陌生人	萧亚轩
突然想起你	萧亚轩
类似爱情	萧亚轩
爱的主打歌	萧亚轩
错的人	萧亚轩
一个人的精彩	萧亚轩
表白	萧亚轩
遗失的心跳	萧亚轩
潇洒小姐	萧亚轩
他和她的故事	萧亚轩
闪闪惹人爱	萧亚轩
吻	萧亚轩
后来的我们	萧亚轩
钻石糖	萧亚轩
倒数	萧亚轩
冲动	萧亚轩
敢伤	萧亚轩
为你我受冷风吹	林忆莲
至少还有你	林忆莲
伤痕	林忆莲
不必在乎我是谁	林忆莲
爱上一个不回家的人	林忆莲
听说爱情回来过	林忆莲
夜太黑	林忆莲
词不达意	林忆莲
领悟	林忆莲
我最亲爱的	林忆莲
远走高飞	林忆莲
失踪	林忆莲
蓝莲花	林忆莲
铿锵玫瑰	林忆莲
当爱已成往事	林忆莲
小情歌	林忆莲
我好想你	林忆莲
情人	杜德伟
无心伤害	杜德伟
跟着我一辈子	杜德伟
把你宠坏	杜德伟
不走	杜德伟
脱掉	杜德伟
钟爱一生	杜德伟
嫁给我	杜德伟
把你藏起来	杜德伟
天真	杜德伟
忘情号	杜德伟
黑色契约	杜德伟
彩虹	杜德伟
制造浪漫	杜德伟
原来我Love	杜德伟
拯救地球	杜德伟
真的想你	杜德伟
你在我的爱情里	杜德伟
我最亲爱的	张惠妹
如果你也听说	张惠妹
我可以抱你吗	张惠妹
连名带姓	张惠妹
记得	张惠妹
听海	张惠妹
趁早	张惠妹
人质	张惠妹
偷故事的人	张惠妹
我要快乐？	张惠妹
好胆你就来	张惠妹
原来你什么都不要	张惠妹
站在高岗上	张惠妹
火	张惠妹
真实	张惠妹
血腥爱情故事	张惠妹
也许明天	张惠妹
勇敢	张惠妹
不浪漫罪名	王杰
谁明浪子心	王杰
我是真的爱上你	王杰
一场游戏一场梦	王杰
伤心1999	王杰
是否我真的一无所有	王杰
安妮	王杰
忘了你忘了我	王杰
说谎的爱人	王杰
英雄泪	王杰
她的背影	王杰
封锁我一生	王杰
你是我胸口永远的痛	王杰
心痛	王杰
一无所有	王杰
几分伤心几分痴	王杰
红尘有你	王杰
回家	王杰
会呼吸的痛	梁静茹
勇气	梁静茹
暖暖	梁静茹
可惜不是你	梁静茹
情歌	梁静茹
问	梁静茹
宁夏	梁静茹
小手拉大手	梁静茹
爱你不是两三天	梁静茹
分手快乐	梁静茹
爱久见人心	梁静茹
给未来的自己	梁静茹
崇拜	梁静茹
没有如果	梁静茹
梦醒时分	梁静茹
偶阵雨	梁静茹
无条件为你	梁静茹
明明很爱你	梁静茹
为了谁	祖海
好运来	祖海
牧羊曲	祖海
爱在天地间	祖海
幸福山歌	祖海
天竺少女	祖海
我家在中国	祖海
再唱为了谁	祖海
和谐中国	祖海
今天是你的生日	祖海
妹妹找哥泪花流	祖海
明月千里寄相思	祖海
刘三姐	祖海
谁的眼泪在飞	祖海
连翘花	祖海
天堂	祖海
月亮代表我的心	祖海
东边太阳西边雨	祖海
另一个天堂	张靓颖
如果这就是爱情	张靓颖
终于等到你	张靓颖
我们说好的	张靓颖
画心	张靓颖
如果爱下去	张靓颖
想你，零点零一分	张靓颖
十里桃花	张靓颖
女儿国	张靓颖
有多少爱可以重来	张靓颖
爱的供养	张靓颖
雨蝶	张靓颖
无字碑	张靓颖
饿狼传说	张靓颖
天下无双	张靓颖
匆匆那年	王菲
红豆	王菲
你在终点等我	王菲
传奇	王菲
人间	王菲
容易受伤的女人	王菲
因为爱情	王菲
流年	王菲
笑忘书	王菲
暗涌	王菲
暧昧	王菲
矜持	王菲
清风徐来	王菲
但愿人长久	王菲
执迷不悔	王菲
爱与痛的边缘	王菲
约定	王菲
宿命	刘忻
太爱你	刘忻
还好遇见	刘忻
老男孩	刘忻
颜色	刘忻
那片海	刘忻
十六年	刘忻
孤单的呼吸	刘忻
羞答答的玫瑰静悄悄地开	刘忻
残忍的缠绵	刘忻
画心	刘忻
一个人	刘忻
如果有一天	刘忻
只有情永在	邝美云
我和春天有个约会	邝美云
寂寞的风	邝美云
再坐一会	邝美云
伤心的我	邝美云
未曾深爱已无情	邝美云
大悲咒	邝美云
最浪漫的事	邝美云
一生只愿爱一次	邝美云
容易受伤的女人	邝美云
冰冻的女人	邝美云
唇印	邝美云
相逢在半生	邝美云
难得有情人	邝美云
心声	邝美云
亲密爱人	邝美云
与龙共舞	邝美云
堆积情感	邝美云
你瞒我瞒	陈柏宇
尊严	陈柏宇
拍一半拖	陈柏宇
别来无恙	陈柏宇
逸后	陈柏宇
告别之前	陈柏宇
原谅我要高飞	陈柏宇
无可厚非	陈柏宇
车匙	陈柏宇
再见不再见	陈柏宇
固执	陈柏宇
永久保存	陈柏宇
你来自那颗星	陈柏宇
断绝来往	陈柏宇
别怕失去	陈柏宇
多此一爱	陈柏宇
原谅我怕黑	陈柏宇
为什么你背着我爱别人	许志安
烂泥	许志安
我还能爱谁	许志安
苦口良药	许志安
会过去的	许志安
上弦月	许志安
昨迟人	许志安
慢慢	许志安
甲乙丙丁	许志安
安静	许志安
淘汰	许志安
千千阙歌	许志安
真心真意	许志安
教我如何不爱他	许志安
乱世俱灭	许志安
从头再来	刘欢
好汉歌	刘欢
弯弯的月亮	刘欢
千万次的问	刘欢
天地在我心	刘欢
凤凰于飞	刘欢
我和你	刘欢
不能这样活	刘欢
我欲成仙	刘欢
糊涂的爱	刘欢
在路上	刘欢
情怨	刘欢
卷珠帘	刘欢
怀念战友	刘欢
菊花台	刘欢
就现在	吴莫愁
我相信	吴莫愁
痒	吴莫愁
想神马有神马	吴莫愁
舞底线	吴莫愁
无所不在	吴莫愁
贪玩蓝月	吴莫愁
五环之歌	吴莫愁
我要给你	庾澄庆
我要给你	吴莫愁
没差	吴莫愁
爱爱爱爱	吴莫愁
一个人生活	吴莫愁
美丽笨女人	吴莫愁
玻璃之情	张国荣
当年情	张国荣
风继续吹	张国荣
沉默是金	张国荣
当爱已成往事	张国荣
倩女幽魂	张国荣
千千阙歌	张国荣
怪你过分美丽	张国荣
我	张国荣
共同渡过	张国荣
风再起时	张国荣
有谁共鸣	张国荣
春夏秋冬	张国荣
至少还有你	张国荣
想你	张国荣
无心睡眠	张国荣
追	张国荣
今生今世	张国荣
雨中的恋人们	黄凯芹
伤感的恋人	黄凯芹
晚秋	黄凯芹
若生命等候	黄凯芹
解情还须系情人	黄凯芹
情深缘浅	黄凯芹
哪里的天空不下雨	黄凯芹
情未了	黄凯芹
伤尽我心的说话	黄凯芹
焚情	黄凯芹
昨夜星辰	黄凯芹
情归何处	黄凯芹
如果你知我苦衷	黄凯芹
平常心	黄凯芹
旧朋友	黄凯芹
相爱很难	黄凯芹
好久不见	黄凯芹
渴望	毛阿敏
相思	毛阿敏
篱笆墙的影子	毛阿敏
辘轳·女人和井	毛阿敏
烛光里的妈妈	毛阿敏
不白活一回	毛阿敏
历史的天空	毛阿敏
女人不是月亮	毛阿敏
千古绝唱	毛阿敏
永远是朋友	毛阿敏
我想有个家	毛阿敏
跟着感觉走	毛阿敏
天之大	毛阿敏
思念	毛阿敏
同一首歌	毛阿敏
绿叶对根的情意	毛阿敏
我只在乎你	毛阿敏
神的传说	毛阿敏
回娘家	毛阿敏
星光灿烂	罗中旭
如果你不再爱了	罗中旭
听海	罗中旭
刺	罗中旭
祝我生日快乐	罗中旭
恋人	罗中旭
流沙	罗中旭
让爱靠近	罗中旭
有你有我	罗中旭
爱在你身边	罗中旭
你快回来	罗中旭
渔家傲.忆端午	罗中旭
爱，很简单	罗中旭
相信自己	罗中旭
往日情	罗中旭
嫁给我吧	罗中旭
为爱存在	罗中旭
